ablalardır	pos=N,tense=PST,per=1,num=PL,evid=NFH	ablalarmışız
akbabasını	pos=N,tense=PST,per=1,num=SG,evid=NFH	akbabaymışız
akrebimizde	pos=N,tense=PST,per=2,num=PL,evid=NFH	akreplermişsiniz
akrebinizde	pos=N,tense=PST,per=3,num=SG,evid=NFH	akrepmişler
akreplerdi	pos=N,tense=PST,per=1,num=PL,evid=NFH	akreplermişiz
aktörlerinizden	pos=N,tense=PST,per=3,num=PL,evid=NFH	aktörlermiş
âlimlerdir	pos=N,tense=PST,per=1,num=SG,evid=NFH	âlimmişiz
âmâyı	pos=N,tense=PST,per=2,num=PL,evid=NFH	âmâlarmışsınız
anahtarı	pos=N,tense=PST,per=3,num=SG,evid=NFH	anahtarmışlar
anahtarmışsınız	pos=N,tense=PST,per=1,num=PL,evid=NFH	anahtarlarmışız
aseksüelinden	pos=N,tense=PST,per=2,num=SG,evid=NFH	aseksüelmişsiniz
aseksüellerinizi	pos=N,tense=PST,per=1,num=PL,evid=NFH	aseksüellermişiz
aygırlara	pos=N,tense=PST,per=2,num=PL,evid=NFH	aygırlarmışsınız
ayılarımı	pos=N,tense=PST,per=2,num=SG,evid=NFH	ayıymışsınız
babalılarına	pos=N,tense=PST,per=1,num=SG,evid=NFH	babalıymışız
babamızı	pos=N,tense=PST,per=2,num=SG,evid=NFH	babaymışsınız
babasızız	pos=N,tense=PST,per=1,num=PL,evid=NFH	babasızlarmışız
babasızlarınızda	pos=N,tense=PST,per=3,num=SG,evid=NFH	babasızmışlar
bağlarıma	pos=N,tense=PST,per=3,num=SG,evid=NFH	bağmışlar
bakıcılarımdan	pos=N,tense=PST,per=1,num=PL,evid=NFH	bakıcılarmışız
baldızımızın	pos=N,tense=PST,per=3,num=PL,evid=NFH	baldızlarmış
balıkçıya	pos=N,tense=PST,per=1,num=PL,evid=NFH	balıkçılarmışız
baytarlarımızdan	pos=N,tense=PST,per=3,num=PL,evid=NFH	baytarlarmış
bazında	pos=N,tense=PST,per=3,num=SG,evid=NFH	bazmışlar
benzerim	pos=N,tense=PST,per=3,num=SG,evid=NFH	benzermişler
beyninizin	pos=N,tense=PST,per=1,num=PL,evid=NFH	beyinlermişiz
biseksüeller	pos=N,tense=PST,per=1,num=PL,evid=NFH	biseksüellermişiz
biseksüellersiniz	pos=N,tense=PST,per=1,num=PL,evid=NFH	biseksüellermişiz
bohçana	pos=N,tense=PST,per=1,num=SG,evid=NFH	bohçaymışız
bölgende	pos=N,tense=PST,per=1,num=PL,evid=NFH	bölgelermişiz
börülcen	pos=N,tense=PST,per=1,num=PL,evid=NFH	börülcelermişiz
boyacı	pos=N,tense=PST,per=3,num=SG,evid=NFH	boyacıymışlar
boyacıydınız	pos=N,tense=PST,per=2,num=SG,evid=NFH	boyacıymışsınız
bozayın	pos=N,tense=PST,per=2,num=PL,evid=NFH	bozayılarmışsınız
çapımın	pos=N,tense=PST,per=2,num=SG,evid=NFH	çapmışsınız
çapınıza	pos=N,tense=PST,per=2,num=PL,evid=NFH	çaplarmışsınız
çedarlarımızın	pos=N,tense=PST,per=1,num=PL,evid=NFH	çedarlarmışız
cephelere	pos=N,tense=PST,per=3,num=SG,evid=NFH	cepheymişler
çerçiden	pos=N,tense=PST,per=3,num=SG,evid=NFH	çerçiymişler
çığırtkanlardınız	pos=N,tense=PST,per=3,num=PL,evid=NFH	çığırtkanlarmış
cininizden	pos=N,tense=PST,per=3,num=PL,evid=NFH	cinlermiş
çırağından	pos=N,tense=PST,per=1,num=PL,evid=NFH	çıraklarmışız
çırağı	pos=N,tense=PST,per=2,num=PL,evid=NFH	çıraklarmışsınız
cisimlerimi	pos=N,tense=PST,per=3,num=PL,evid=NFH	cisimlermiş
çöpçatanlarım	pos=N,tense=PST,per=2,num=PL,evid=NFH	çöpçatanlarmışsınız
cümleni	pos=N,tense=PST,per=2,num=SG,evid=NFH	cümleymişsiniz
dadınıza	pos=N,tense=PST,per=2,num=PL,evid=NFH	dadılarmışsınız
değişkenlerimize	pos=N,tense=PST,per=3,num=SG,evid=NFH	değişkenmişler
dükümüzden	pos=N,tense=PST,per=1,num=PL,evid=NFH	düklermişiz
düşmanlarmışız	pos=N,tense=PST,per=3,num=SG,evid=NFH	düşmanmışlar
ecelerini	pos=N,tense=PST,per=2,num=PL,evid=NFH	ecelermişsiniz
efesinden	pos=N,tense=PST,per=3,num=SG,evid=NFH	efeymişler
embriyolarımdan	pos=N,tense=PST,per=2,num=PL,evid=NFH	embriyolarmışsınız
embriyolarmışız	pos=N,tense=PST,per=3,num=PL,evid=NFH	embriyolarmış
emmiye	pos=N,tense=PST,per=2,num=PL,evid=NFH	emmilermişsiniz
erkecelden	pos=N,tense=PST,per=1,num=SG,evid=NFH	erkecelmişiz
erkecellerimize	pos=N,tense=PST,per=1,num=SG,evid=NFH	erkecelmişiz
eşcinselimizden	pos=N,tense=PST,per=2,num=PL,evid=NFH	eşcinsellermişsiniz
eşyalarından	pos=N,tense=PST,per=3,num=PL,evid=NFH	eşyalarmış
fahişeymişiz	pos=N,tense=PST,per=1,num=PL,evid=NFH	fahişelermişiz
fasığınızdan	pos=N,tense=PST,per=2,num=SG,evid=NFH	fasıkmışsınız
figüranlarımızı	pos=N,tense=PST,per=2,num=SG,evid=NFH	figüranmışsınız
fişeklerinin	pos=N,tense=PST,per=3,num=SG,evid=NFH	fişekmişler
fizikçilerimden	pos=N,tense=PST,per=1,num=PL,evid=NFH	fizikçilermişiz
gazelmişler	pos=N,tense=PST,per=2,num=PL,evid=NFH	gazellermişsiniz
götlerinizin	pos=N,tense=PST,per=1,num=PL,evid=NFH	götlermişiz
gözlükçüsüne	pos=N,tense=PST,per=1,num=SG,evid=NFH	gözlükçüymüşüz
gübrelerdik	pos=N,tense=PST,per=3,num=SG,evid=NFH	gübreymişler
gübrelerdir	pos=N,tense=PST,per=3,num=SG,evid=NFH	gübreymişler
güreşçimin	pos=N,tense=PST,per=1,num=PL,evid=NFH	güreşçilermişiz
hacında	pos=N,tense=PST,per=3,num=PL,evid=NFH	hacılarmış
hastalarımızda	pos=N,tense=PST,per=1,num=PL,evid=NFH	hastalarmışız
hırsızmışlar	pos=N,tense=PST,per=3,num=PL,evid=NFH	hırsızlarmış
homoseksüel	pos=N,tense=PST,per=2,num=PL,evid=NFH	homoseksüellermişsiniz
huzurlara	pos=N,tense=PST,per=1,num=PL,evid=NFH	huzurlarmışız
idealdik	pos=N,tense=PST,per=3,num=SG,evid=NFH	idealmişler
ideallerdi	pos=N,tense=PST,per=1,num=SG,evid=NFH	idealmişiz
incilerimin	pos=N,tense=PST,per=3,num=SG,evid=NFH	inciymişler
insanımsımızdan	pos=N,tense=PST,per=1,num=PL,evid=NFH	insanımsılarmışız
irkeneğinize	pos=N,tense=PST,per=1,num=PL,evid=NFH	irkeneklermişiz
iskenderlerdir	pos=N,tense=PST,per=2,num=SG,evid=NFH	iskendermişsiniz
iskenderleriz	pos=N,tense=PST,per=2,num=PL,evid=NFH	iskenderlermişsiniz
istisnalara	pos=N,tense=PST,per=1,num=SG,evid=NFH	istisnaymışız
istisnana	pos=N,tense=PST,per=1,num=PL,evid=NFH	istisnalarmışız
istisnaydılar	pos=N,tense=PST,per=3,num=SG,evid=NFH	istisnaymışlar
kabakmışız	pos=N,tense=PST,per=2,num=SG,evid=NFH	kabakmışsınız
kaltağınızın	pos=N,tense=PST,per=3,num=PL,evid=NFH	kaltaklarmış
kaltakları	pos=N,tense=PST,per=3,num=PL,evid=NFH	kaltaklarmış
kapaklarınızdan	pos=N,tense=PST,per=1,num=SG,evid=NFH	kapakmışız
karakteriniz	pos=N,tense=PST,per=2,num=SG,evid=NFH	karaktermişsiniz
karaktermişler	pos=N,tense=PST,per=1,num=PL,evid=NFH	karakterlermişiz
kardeşlerdiniz	pos=N,tense=PST,per=3,num=PL,evid=NFH	kardeşlermiş
kaşarlarıma	pos=N,tense=PST,per=1,num=SG,evid=NFH	kaşarmışız
katillerinize	pos=N,tense=PST,per=3,num=PL,evid=NFH	katillermiş
keçilerinizi	pos=N,tense=PST,per=3,num=SG,evid=NFH	keçiymişler
keçilermişsiniz	pos=N,tense=PST,per=2,num=SG,evid=NFH	keçiymişsiniz
keserları	pos=N,tense=PST,per=1,num=SG,evid=NFH	keserymışız
kırtasiyeniz	pos=N,tense=PST,per=3,num=PL,evid=NFH	kırtasiyelermiş
kıyafetlerinde	pos=N,tense=PST,per=1,num=PL,evid=NFH	kıyafetlermişiz
kuğunuzu	pos=N,tense=PST,per=2,num=PL,evid=NFH	kuğularmışsınız
kümeslerinde	pos=N,tense=PST,per=1,num=PL,evid=NFH	kümeslermişiz
kunduzdular	pos=N,tense=PST,per=1,num=PL,evid=NFH	kunduzlarmışız
lahanandan	pos=N,tense=PST,per=3,num=SG,evid=NFH	lahanaymışlar
makinamıza	pos=N,tense=PST,per=1,num=SG,evid=NFH	makinaymışız
makinasınız	pos=N,tense=PST,per=3,num=SG,evid=NFH	makinaymışlar
maktalarında	pos=N,tense=PST,per=1,num=SG,evid=NFH	maktaymışız
maktaların	pos=N,tense=PST,per=2,num=PL,evid=NFH	maktalarmışsınız
mandalinalardı	pos=N,tense=PST,per=2,num=SG,evid=NFH	mandalinaymışsınız
manitalarımızda	pos=N,tense=PST,per=3,num=PL,evid=NFH	manitalarmış
marangozların	pos=N,tense=PST,per=2,num=PL,evid=NFH	marangozlarmışsınız
marangozu	pos=N,tense=PST,per=2,num=PL,evid=NFH	marangozlarmışsınız
maskaralardık	pos=N,tense=PST,per=3,num=SG,evid=NFH	maskaraymışlar
matlalarınızdan	pos=N,tense=PST,per=2,num=SG,evid=NFH	matlaymışsınız
matlalar	pos=N,tense=PST,per=1,num=SG,evid=NFH	matlaymışız
maymunum	pos=N,tense=PST,per=3,num=SG,evid=NFH	maymunmuşlar
metrdotelimde	pos=N,tense=PST,per=3,num=SG,evid=NFH	metrdotelmişler
metrdotelimi	pos=N,tense=PST,per=1,num=PL,evid=NFH	metrdotellermişiz
mucizelerimin	pos=N,tense=PST,per=3,num=SG,evid=NFH	mucizeymişler
müellifi	pos=N,tense=PST,per=2,num=SG,evid=NFH	müellifmişsiniz
müelliflerinizi	pos=N,tense=PST,per=3,num=SG,evid=NFH	müellifmişler
mügende	pos=N,tense=PST,per=2,num=PL,evid=NFH	mügelermişsiniz
mümessillerimiz	pos=N,tense=PST,per=3,num=PL,evid=NFH	mümessillermiş
musluklarımıza	pos=N,tense=PST,per=2,num=SG,evid=NFH	muslukmuşsunuz
müstahdeminizi	pos=N,tense=PST,per=1,num=SG,evid=NFH	müstahdemmişiz
müşterimde	pos=N,tense=PST,per=2,num=PL,evid=NFH	müşterilermişsiniz
nedimelerimizin	pos=N,tense=PST,per=3,num=PL,evid=NFH	nedimelermiş
nişanlılarını	pos=N,tense=PST,per=3,num=SG,evid=NFH	nişanlıymışlar
nohutlarınızdan	pos=N,tense=PST,per=2,num=PL,evid=NFH	nohutlarmışsınız
odacısı	pos=N,tense=PST,per=1,num=PL,evid=NFH	odacılarmışız
oğlancımın	pos=N,tense=PST,per=2,num=PL,evid=NFH	oğlancılarmışsınız
öğrenciden	pos=N,tense=PST,per=3,num=PL,evid=NFH	öğrencilermiş
öğütücülerimi	pos=N,tense=PST,per=2,num=PL,evid=NFH	öğütücülermişsiniz
ölülerinden	pos=N,tense=PST,per=1,num=PL,evid=NFH	ölülermişiz
ölün	pos=N,tense=PST,per=3,num=SG,evid=NFH	ölüymüşler
ombudsmanlarınızda	pos=N,tense=PST,per=3,num=PL,evid=NFH	ombudsmanlarmış
orospumuz	pos=N,tense=PST,per=3,num=SG,evid=NFH	orospuymuşlar
örtüsünün	pos=N,tense=PST,per=3,num=SG,evid=NFH	örtüymüşler
palikaryalarınızda	pos=N,tense=PST,per=1,num=SG,evid=NFH	palikaryaymışız
pandispanyalarmışız	pos=N,tense=PST,per=3,num=SG,evid=NFH	pandispanyaymışlar
papalardır	pos=N,tense=PST,per=1,num=PL,evid=NFH	papalarmışız
paparazilerimizi	pos=N,tense=PST,per=1,num=PL,evid=NFH	paparazilermişiz
paparazime	pos=N,tense=PST,per=3,num=PL,evid=NFH	paparazilermiş
parlatıcılarınızı	pos=N,tense=PST,per=1,num=SG,evid=NFH	parlatıcıymışız
pastırmalarız	pos=N,tense=PST,per=1,num=SG,evid=NFH	pastırmaymışız
pastırmanızın	pos=N,tense=PST,per=2,num=PL,evid=NFH	pastırmalarmışsınız
pipetlerde	pos=N,tense=PST,per=2,num=PL,evid=NFH	pipetlermişsiniz
prensime	pos=N,tense=PST,per=3,num=PL,evid=NFH	prenslermiş
rubailerde	pos=N,tense=PST,per=3,num=SG,evid=NFH	rubaiymişler
saksocumuz	pos=N,tense=PST,per=1,num=SG,evid=NFH	saksocuymuşuz
saksocuydular	pos=N,tense=PST,per=2,num=SG,evid=NFH	saksocuymuşsunuz
sapanımızda	pos=N,tense=PST,per=3,num=SG,evid=NFH	sapanmışlar
sarılarım	pos=N,tense=PST,per=2,num=PL,evid=NFH	sarılarmışsınız
sarınızda	pos=N,tense=PST,per=2,num=SG,evid=NFH	sarıymışsınız
satışlardan	pos=N,tense=PST,per=2,num=SG,evid=NFH	satışmışsınız
sayfaymışlar	pos=N,tense=PST,per=3,num=PL,evid=NFH	sayfalarmış
seçmeninize	pos=N,tense=PST,per=3,num=SG,evid=NFH	seçmenmişler
şekerimizde	pos=N,tense=PST,per=1,num=SG,evid=NFH	şekermişiz
şelalenizi	pos=N,tense=PST,per=1,num=SG,evid=NFH	şelaleymişiz
şerbetçim	pos=N,tense=PST,per=3,num=SG,evid=NFH	şerbetçiymişler
şeymişiz	pos=N,tense=PST,per=3,num=SG,evid=NFH	şeymişler
şeysiniz	pos=N,tense=PST,per=1,num=SG,evid=NFH	şeymişiz
sıçanlarınızdan	pos=N,tense=PST,per=1,num=SG,evid=NFH	sıçanmışız
sineği	pos=N,tense=PST,per=2,num=SG,evid=NFH	sinekmişsiniz
sonların	pos=N,tense=PST,per=2,num=SG,evid=NFH	sonmuşsunuz
sonucumuzdan	pos=N,tense=PST,per=3,num=SG,evid=NFH	sonuçmuşlar
sonunun	pos=N,tense=PST,per=3,num=SG,evid=NFH	sonmuşlar
sözcülermişiz	pos=N,tense=PST,per=1,num=SG,evid=NFH	sözcüymüşüz
sporcuyduk	pos=N,tense=PST,per=3,num=SG,evid=NFH	sporcuymuşlar
sürücülerinizde	pos=N,tense=PST,per=2,num=SG,evid=NFH	sürücüymüşsünüz
sürücüleri	pos=N,tense=PST,per=1,num=SG,evid=NFH	sürücüymüşüz
süsünün	pos=N,tense=PST,per=2,num=SG,evid=NFH	süsmüşsünüz
tabansızınızdan	pos=N,tense=PST,per=3,num=PL,evid=NFH	tabansızlarmış
takılarmışsınız	pos=N,tense=PST,per=3,num=SG,evid=NFH	takıymışlar
taklitçini	pos=N,tense=PST,per=3,num=SG,evid=NFH	taklitçiymişler
tarihçi	pos=N,tense=PST,per=3,num=SG,evid=NFH	tarihçiymişler
taykonotlarsınız	pos=N,tense=PST,per=1,num=SG,evid=NFH	taykonotmuşuz
tekilan	pos=N,tense=PST,per=2,num=SG,evid=NFH	tekilaymışsınız
telaffuzduk	pos=N,tense=PST,per=1,num=SG,evid=NFH	telaffuzmuşuz
temsilciliğiniz	pos=N,tense=PST,per=2,num=PL,evid=NFH	temsilciliklermişsiniz
tenisçiyi	pos=N,tense=PST,per=3,num=SG,evid=NFH	tenisçiymişler
terapistimiz	pos=N,tense=PST,per=2,num=SG,evid=NFH	terapistmişsiniz
tercihlerini	pos=N,tense=PST,per=1,num=SG,evid=NFH	tercihmişiz
tercümanlarınıza	pos=N,tense=PST,per=2,num=SG,evid=NFH	tercümanmışsınız
tercümanlarınızdan	pos=N,tense=PST,per=3,num=SG,evid=NFH	tercümanmışlar
terörlerimizden	pos=N,tense=PST,per=1,num=SG,evid=NFH	terörmüşüz
terörlermişiz	pos=N,tense=PST,per=1,num=SG,evid=NFH	terörmüşüz
terzime	pos=N,tense=PST,per=3,num=PL,evid=NFH	terzilermiş
torunumda	pos=N,tense=PST,per=2,num=SG,evid=NFH	torunmuşsunuz
torununuzu	pos=N,tense=PST,per=3,num=PL,evid=NFH	torunlarmış
totemcilerini	pos=N,tense=PST,per=3,num=SG,evid=NFH	totemciymişler
tuğralarımız	pos=N,tense=PST,per=2,num=PL,evid=NFH	tuğralarmışsınız
tümcemin	pos=N,tense=PST,per=1,num=SG,evid=NFH	tümceymişiz
tundralarıma	pos=N,tense=PST,per=1,num=SG,evid=NFH	tundraymışız
tundraya	pos=N,tense=PST,per=2,num=PL,evid=NFH	tundralarmışsınız
turşumda	pos=N,tense=PST,per=3,num=SG,evid=NFH	turşuymuşlar
tutkularını	pos=N,tense=PST,per=2,num=PL,evid=NFH	tutkularmışsınız
tütsülerde	pos=N,tense=PST,per=3,num=SG,evid=NFH	tütsüymüşler
ucubenden	pos=N,tense=PST,per=2,num=SG,evid=NFH	ucubeymişsiniz
ulamın	pos=N,tense=PST,per=1,num=PL,evid=NFH	ulamlarmışız
ulamlarmışsınız	pos=N,tense=PST,per=3,num=PL,evid=NFH	ulamlarmış
üreticilerini	pos=N,tense=PST,per=3,num=SG,evid=NFH	üreticiymişler
üreticilerinizin	pos=N,tense=PST,per=3,num=SG,evid=NFH	üreticiymişler
uzaklarımızda	pos=N,tense=PST,per=2,num=SG,evid=NFH	uzakmışsınız
yangınlarınızın	pos=N,tense=PST,per=2,num=PL,evid=NFH	yangınlarmışsınız
yardımcılarına	pos=N,tense=PST,per=3,num=PL,evid=NFH	yardımcılarmış
yardımcılığının	pos=N,tense=PST,per=1,num=SG,evid=NFH	yardımcılıkmışız
yardımcılıklarımda	pos=N,tense=PST,per=2,num=PL,evid=NFH	yardımcılıklarmışsınız
yarınlarınızı	pos=N,tense=PST,per=1,num=PL,evid=NFH	yarınlarmışız
yasaktınız	pos=N,tense=PST,per=1,num=SG,evid=NFH	yasakmışız
yedeklerimin	pos=N,tense=PST,per=1,num=PL,evid=NFH	yedeklermişiz
yeterliklerdir	pos=N,tense=PST,per=3,num=PL,evid=NFH	yeterliklermiş
yeterliliğinizi	pos=N,tense=PST,per=1,num=PL,evid=NFH	yeterliliklermişiz
yolcusuna	pos=N,tense=PST,per=3,num=SG,evid=NFH	yolcuymuşlar
yolcuyduk	pos=N,tense=PST,per=3,num=SG,evid=NFH	yolcuymuşlar
yoldaşlarımızda	pos=N,tense=PST,per=1,num=PL,evid=NFH	yoldaşlarmışız
yüzüncüyüme	pos=N,tense=PST,per=2,num=PL,evid=NFH	yüzüncülermişsiniz
zağarınızın	pos=N,tense=PST,per=1,num=PL,evid=NFH	zağarlarmışız
ziyaretçilerdik	pos=N,tense=PST,per=1,num=SG,evid=NFH	ziyaretçiymişiz
