fejedelemnek	pos=N,case=TRANS,num=PL	fejedelmekké
khmerekké	pos=N,case=DAT,num=SG	khmernek
nevelőnőt	pos=N,case=IN+ALL,num=SG	nevelőnőbe
alapban	pos=N,case=PRP,num=SG	alapért
osztályokként	pos=N,case=IN+ESS,num=PL	osztályokban
remekről	pos=N,case=TERM,num=SG	remekig
sebtapasznál	pos=N,case=IN+ALL,num=PL	sebtapaszokba
apácafőnöknőbe	pos=N,case=ON+ABL,num=PL	apácafőnöknőkről
céljaink	pos=N,case=DAT,num=PL	céloknak
szállásai	pos=N,case=DAT,num=SG	szállásnak
rendelkezésen	pos=N,case=ABL,num=PL	rendelkezésektől
alappá	pos=N,case=ON+ESS,num=PL	alapokon
fejedelmekként	pos=N,case=TERM,num=PL	fejedelmekig
ógörögnél	pos=N,case=TERM,num=SG	ógörögig
halmazul	pos=N,case=NOM,num=SG	halmaz
példákból	pos=N,case=ON+ESS,num=SG	példán
fejedelmekre	pos=N,case=PRP,num=PL	fejedelmekért
példaképed	pos=N,case=TRANS,num=PL	példaképekké
szállásaitok	pos=N,case=INS,num=PL	szállásokkal
flamandokra	pos=N,case=TRANS,num=PL	flamandokká
halmazoknál	pos=N,case=IN+ABL,num=SG	halmazból
rendelkezésbe	pos=N,case=TERM,num=SG	rendelkezésig
őrnek	pos=N,case=BYWAY,num=SG	őrül
hollandokba	pos=N,case=PRP,num=PL	hollandokért
ürügyeknek	pos=N,case=FRML,num=PL	ürügyekként
flamandnál	pos=N,case=AT+ESS,num=PL	flamandoknál
kutyákon	pos=N,case=ON+ALL,num=SG	kutyára
úrnőik	pos=N,case=ALL,num=PL	úrnőkhöz
fejedelmekké	pos=N,case=TRANS,num=SG	fejedelemmé
szabályozásba	pos=N,case=FRML,num=SG	szabályozásként
lengyeleknél	pos=N,case=INS,num=SG	lengyellel
alapokat	pos=N,case=BYWAY,num=SG	alapul
arcoktól	pos=N,case=AT+ESS,num=SG	arcnál
döntéssé	pos=N,case=ON+ABL,num=PL	döntésekről
elismerésünk	pos=N,case=TERM,num=PL	elismerésekig
sógornőhöz	pos=N,case=PRP,num=SG	sógornőért
észtekből	pos=N,case=ACC,num=SG	észtet
bosnyákot	pos=N,case=BYWAY,num=SG	bosnyákul
természeteik	pos=N,case=ON+ALL,num=PL	természetekre
bővítéseknél	pos=N,case=TRANS,num=SG	bővítéssé
alosztályokként	pos=N,case=TRANS,num=PL	alosztályokká
megállapodásban	pos=N,case=ACC,num=PL	megállapodásokat
megállapodásom	pos=N,case=NOM,num=SG	megállapodás
rendőrnőkért	pos=N,case=AT+ESS,num=PL	rendőrnőknél
sebtapaszoktól	pos=N,case=AT+ESS,num=SG	sebtapasznál
árindexeken	pos=N,case=TERM,num=PL	árindexekig
apátnők	pos=N,case=DAT,num=PL	apátnőknek
rendelkezést	pos=N,case=ON+ABL,num=SG	rendelkezésről
ajándékhoz	pos=N,case=IN+ABL,num=PL	ajándékokból
díjra	pos=N,case=INS,num=PL	díjakkal
választól	pos=N,case=ON+ALL,num=SG	válaszra
kurdoknál	pos=N,case=ON+ABL,num=SG	kurdról
célpontul	pos=N,case=TERM,num=SG	célpontig
hollandokká	pos=N,case=PRP,num=SG	hollandért
mentséggé	pos=N,case=ON+ALL,num=SG	mentségre
japánjaim	pos=N,case=ON+ABL,num=PL	japánokról
varrónőtök	pos=N,case=ACC,num=SG	varrónőt
tulajdonosnőim	pos=N,case=ABL,num=PL	tulajdonosnőktől
nyenyeced	pos=N,case=BYWAY,num=SG	nyenyecül
apácafőnöknőn	pos=N,case=TRANS,num=PL	apácafőnöknőkké
halmazzá	pos=N,case=INS,num=SG	halmazzal
őrökig	pos=N,case=ACC,num=SG	őrt
tulajdonosnőnk	pos=N,case=ON+ALL,num=PL	tulajdonosnőkre
bosnyákba	pos=N,case=ON+ESS,num=SG	bosnyákon
természeteim	pos=N,case=PRP,num=PL	természetekért
adata	pos=N,case=ACC,num=PL	adatokat
példákért	pos=N,case=ON+ABL,num=SG	példáról
baskírról	pos=N,case=IN+ABL,num=PL	baskírokból
adománynak	pos=N,case=ALL,num=SG	adományhoz
osztállyá	pos=N,case=NOM,num=PL	osztályok
fejedelemben	pos=N,case=PRP,num=PL	fejedelmekért
bázisokká	pos=N,case=PRP,num=PL	bázisokért
apácafőnöknőkké	pos=N,case=INS,num=PL	apácafőnöknőkkel
akadályaid	pos=N,case=TERM,num=PL	akadályokig
célokra	pos=N,case=TRANS,num=SG	céllá
tudomással	pos=N,case=ABL,num=SG	tudomástól
vánkosért	pos=N,case=ABL,num=PL	vánkosoktól
portugálokban	pos=N,case=ON+ESS,num=PL	portugálokon
magyarokat	pos=N,case=ABL,num=PL	magyaroktól
tulajdonosnőre	pos=N,case=TRANS,num=SG	tulajdonosnővé
könyvtárosnőtől	pos=N,case=ON+ALL,num=PL	könyvtárosnőkre
nagydíjba	pos=N,case=ON+ALL,num=PL	nagydíjakra
bővítésekké	pos=N,case=ON+ESS,num=PL	bővítéseken
japánnál	pos=N,case=IN+ESS,num=SG	japánban
díszből	pos=N,case=ABL,num=PL	díszektől
bázissal	pos=N,case=IN+ABL,num=SG	bázisból
akadályért	pos=N,case=ON+ESS,num=PL	akadályokon
japánjaink	pos=N,case=ON+ESS,num=PL	japánokon
úrnővé	pos=N,case=ACC,num=SG	úrnőt
vízikutyája	pos=N,case=NOM,num=PL	vízikutyák
bázisoktól	pos=N,case=IN+ABL,num=SG	bázisból
észtekké	pos=N,case=DAT,num=SG	észtnek
elismerésem	pos=N,case=TERM,num=PL	elismerésekig
fakírnak	pos=N,case=IN+ABL,num=SG	fakírból
feleségekként	pos=N,case=TERM,num=PL	feleségekig
díjként	pos=N,case=INS,num=SG	díjjal
kertnél	pos=N,case=INS,num=PL	kertekkel
döntéseken	pos=N,case=ALL,num=PL	döntésekhez
lengyelhez	pos=N,case=DAT,num=SG	lengyelnek
tudomásod	pos=N,case=NOM,num=PL	tudomások
baskírod	pos=N,case=IN+ESS,num=SG	baskírban
nyenyeceid	pos=N,case=ALL,num=SG	nyenyechez
sebtapasza	pos=N,case=DAT,num=PL	sebtapaszoknak
bázisokban	pos=N,case=PRP,num=PL	bázisokért
adatot	pos=N,case=ON+ALL,num=SG	adatra
adataitok	pos=N,case=IN+ABL,num=PL	adatokból
akadályokként	pos=N,case=IN+ESS,num=PL	akadályokban
apácafőnöknőkhöz	pos=N,case=BYWAY,num=SG	apácafőnöknőül
arabokról	pos=N,case=ON+ABL,num=SG	arabról
flamandba	pos=N,case=ON+ALL,num=SG	flamandra
fakírnál	pos=N,case=IN+ABL,num=SG	fakírból
osztályban	pos=N,case=DAT,num=PL	osztályoknak
úrnőim	pos=N,case=PRP,num=PL	úrnőkért
fejedelmeitek	pos=N,case=IN+ESS,num=SG	fejedelemben
díszed	pos=N,case=INS,num=SG	dísszel
baskírokig	pos=N,case=ON+ESS,num=SG	baskíron
törzsnél	pos=N,case=IN+ABL,num=SG	törzsből
szabályozásoknak	pos=N,case=BYWAY,num=SG	szabályozásul
példáim	pos=N,case=AT+ESS,num=PL	példáknál
fejedelemként	pos=N,case=TRANS,num=PL	fejedelmekké
remek	pos=N,case=IN+ALL,num=PL	remekekbe
mentségeim	pos=N,case=PRP,num=PL	mentségekért
céljaink	pos=N,case=TRANS,num=PL	célokká
feleségem	pos=N,case=DAT,num=SG	feleségnek
észtben	pos=N,case=IN+ESS,num=PL	észtekben
fakírból	pos=N,case=AT+ESS,num=PL	fakíroknál
magyarra	pos=N,case=IN+ABL,num=PL	magyarokból
apácafőnöknőt	pos=N,case=IN+ALL,num=PL	apácafőnöknőkbe
baskíroktól	pos=N,case=ON+ABL,num=PL	baskírokról
angoltól	pos=N,case=ON+ALL,num=PL	angolokra
rendőrnőből	pos=N,case=IN+ALL,num=SG	rendőrnőbe
törzsnél	pos=N,case=IN+ALL,num=PL	törzsekbe
tanítványaink	pos=N,case=PRP,num=PL	tanítványokért
kutyád	pos=N,case=TERM,num=SG	kutyáig
példaképem	pos=N,case=AT+ESS,num=SG	példaképnél
fejedelemül	pos=N,case=FRML,num=SG	fejedelemként
nyenyecekké	pos=N,case=ABL,num=PL	nyenyecektől
baskírról	pos=N,case=NOM,num=PL	baskírok
ágytálaid	pos=N,case=TRANS,num=PL	ágytálakká
magyarod	pos=N,case=FRML,num=PL	magyarokként
adomány	pos=N,case=FRML,num=PL	adományokként
árindexért	pos=N,case=TRANS,num=PL	árindexekké
vánkosul	pos=N,case=DAT,num=SG	vánkosnak
hollandoknak	pos=N,case=DAT,num=SG	hollandnak
arcaim	pos=N,case=IN+ESS,num=SG	arcban
fejedelmeknek	pos=N,case=IN+ALL,num=PL	fejedelmekbe
németekig	pos=N,case=BYWAY,num=SG	németül
ágytálból	pos=N,case=ALL,num=SG	ágytálhoz
válaszokhoz	pos=N,case=IN+ESS,num=SG	válaszban
árindexre	pos=N,case=PRP,num=PL	árindexekért
úrnővel	pos=N,case=PRP,num=PL	úrnőkért
díszekben	pos=N,case=ON+ESS,num=SG	díszen
őrön	pos=N,case=IN+ALL,num=PL	őrökbe
halmazoknak	pos=N,case=NOM,num=SG	halmaz
bővítésre	pos=N,case=NOM,num=PL	bővítések
akadálytól	pos=N,case=ON+ABL,num=SG	akadályról
khmered	pos=N,case=IN+ALL,num=SG	khmerbe
japánról	pos=N,case=INS,num=PL	japánokkal
portugállal	pos=N,case=TRANS,num=SG	portugállá
vízikutyánk	pos=N,case=IN+ESS,num=PL	vízikutyákban
példaképnek	pos=N,case=TRANS,num=SG	példaképpé
őrré	pos=N,case=IN+ALL,num=SG	őrbe
arcokon	pos=N,case=ON+ABL,num=PL	arcokról
mentséged	pos=N,case=IN+ABL,num=PL	mentségekből
adományokhoz	pos=N,case=ON+ALL,num=PL	adományokra
tudomásokká	pos=N,case=IN+ESS,num=SG	tudomásban
könyvtárosnőtök	pos=N,case=ALL,num=PL	könyvtárosnőkhöz
döntésekként	pos=N,case=FRML,num=SG	döntésként
apácafőnöknőknél	pos=N,case=NOM,num=SG	apácafőnöknő
németekbe	pos=N,case=PRP,num=PL	németekért
ösztöndíjként	pos=N,case=TRANS,num=SG	ösztöndíjjá
válaszokkal	pos=N,case=TRANS,num=SG	válasszá
tanítványai	pos=N,case=ON+ALL,num=SG	tanítványra
bizonyítékokkal	pos=N,case=IN+ALL,num=PL	bizonyítékokba
lengyellé	pos=N,case=ON+ESS,num=PL	lengyeleken
ágytálakra	pos=N,case=ON+ABL,num=PL	ágytálakról
apácafőnöknői	pos=N,case=FRML,num=PL	apácafőnöknőkként
tudomásokban	pos=N,case=DAT,num=SG	tudomásnak
megállapodáson	pos=N,case=TRANS,num=PL	megállapodásokká
ösztöndíjakért	pos=N,case=NOM,num=SG	ösztöndíj
rendelkezéstől	pos=N,case=DAT,num=SG	rendelkezésnek
rendelkezésből	pos=N,case=ON+ABL,num=SG	rendelkezésről
varrónőben	pos=N,case=ON+ALL,num=PL	varrónőkre
úrnőt	pos=N,case=TERM,num=PL	úrnőkig
szabályozásokat	pos=N,case=ABL,num=SG	szabályozástól
példáink	pos=N,case=IN+ESS,num=PL	példákban
adatként	pos=N,case=ON+ABL,num=PL	adatokról
fejedelemtől	pos=N,case=ON+ESS,num=PL	fejedelmeken
bázisunk	pos=N,case=TRANS,num=SG	bázissá
apácafőnöknőkhöz	pos=N,case=PRP,num=SG	apácafőnöknőért
sebtapaszokként	pos=N,case=ALL,num=PL	sebtapaszokhoz
varrónőkként	pos=N,case=TERM,num=PL	varrónőkig
útpadkához	pos=N,case=ACC,num=PL	útpadkákat
nyenyecektől	pos=N,case=IN+ALL,num=SG	nyenyecbe
észtekre	pos=N,case=TERM,num=SG	észtig
útpadkáim	pos=N,case=ALL,num=PL	útpadkákhoz
tudomásoktól	pos=N,case=ON+ALL,num=PL	tudomásokra
célokként	pos=N,case=ACC,num=SG	célt
portugálokként	pos=N,case=ALL,num=PL	portugálokhoz
németei	pos=N,case=INS,num=SG	némettel
elismeréseknél	pos=N,case=TERM,num=PL	elismerésekig
ajándék	pos=N,case=IN+ABL,num=SG	ajándékból
fakírt	pos=N,case=DAT,num=SG	fakírnak
portugáloktól	pos=N,case=FRML,num=PL	portugálokként
alap	pos=N,case=INS,num=SG	alappal
ágytálnál	pos=N,case=ON+ABL,num=SG	ágytálról
elismerésig	pos=N,case=IN+ALL,num=PL	elismerésekbe
nagydíjakhoz	pos=N,case=ABL,num=PL	nagydíjaktól
ajándékokról	pos=N,case=IN+ESS,num=SG	ajándékban
nyenyecekből	pos=N,case=ALL,num=PL	nyenyecekhez
angolokká	pos=N,case=TRANS,num=SG	angollá
adatot	pos=N,case=TERM,num=SG	adatig
angolokkal	pos=N,case=FRML,num=PL	angolokként
ógörögbe	pos=N,case=FRML,num=SG	ógörögként
feleségük	pos=N,case=ON+ESS,num=SG	feleségen
természetbe	pos=N,case=ON+ABL,num=SG	természetről
ajándékhoz	pos=N,case=INS,num=SG	ajándékkal
sógornőért	pos=N,case=ABL,num=SG	sógornőtől
díjba	pos=N,case=NOM,num=PL	díjak
szállásokért	pos=N,case=ON+ESS,num=SG	szálláson
példákban	pos=N,case=DAT,num=SG	példának
kertünk	pos=N,case=INS,num=PL	kertekkel
apácafőnöknőként	pos=N,case=NOM,num=PL	apácafőnöknők
baskírja	pos=N,case=PRP,num=SG	baskírért
ürügyeken	pos=N,case=IN+ESS,num=SG	ürügyben
rendelkezésért	pos=N,case=AT+ESS,num=PL	rendelkezéseknél
útpadkákra	pos=N,case=IN+ALL,num=SG	útpadkába
eszményeik	pos=N,case=ON+ALL,num=SG	eszményre
adomány	pos=N,case=PRP,num=SG	adományért
bázist	pos=N,case=IN+ESS,num=PL	bázisokban
fakírokhoz	pos=N,case=TRANS,num=SG	fakírrá
halmazzal	pos=N,case=ON+ALL,num=PL	halmazokra
úrnőink	pos=N,case=IN+ESS,num=SG	úrnőben
angoljaim	pos=N,case=INS,num=PL	angolokkal
tudomásokhoz	pos=N,case=ON+ESS,num=SG	tudomáson
lengyellel	pos=N,case=ALL,num=PL	lengyelekhez
németeitek	pos=N,case=ON+ALL,num=SG	németre
adománnyá	pos=N,case=ON+ESS,num=PL	adományokon
apácafőnöknővel	pos=N,case=ALL,num=PL	apácafőnöknőkhöz
elismeréseknél	pos=N,case=NOM,num=SG	elismerés
akadályként	pos=N,case=IN+ALL,num=SG	akadályba
árindexed	pos=N,case=DAT,num=SG	árindexnek
flamandul	pos=N,case=IN+ALL,num=PL	flamandokba
vég	pos=N,case=INS,num=SG	véggel
tulajdonosnőkre	pos=N,case=DAT,num=PL	tulajdonosnőknek
végre	pos=N,case=AT+ESS,num=PL	végeknél
útpadkákról	pos=N,case=PRP,num=SG	útpadkáért
díszbe	pos=N,case=ACC,num=PL	díszeket
adományokat	pos=N,case=ABL,num=PL	adományoktól
apátnőhöz	pos=N,case=ON+ALL,num=PL	apátnőkre
bizonyítékunk	pos=N,case=NOM,num=PL	bizonyítékok
természetekbe	pos=N,case=BYWAY,num=SG	természetül
bővítéseket	pos=N,case=BYWAY,num=SG	bővítésül
úrnőig	pos=N,case=TRANS,num=PL	úrnőkké
célpontokból	pos=N,case=ACC,num=PL	célpontokat
magyarokhoz	pos=N,case=ON+ESS,num=PL	magyarokon
arcokban	pos=N,case=AT+ESS,num=PL	arcoknál
ajándékokon	pos=N,case=INS,num=PL	ajándékokkal
akadályban	pos=N,case=ON+ABL,num=SG	akadályról
angolul	pos=N,case=DAT,num=PL	angoloknak
németnek	pos=N,case=ACC,num=PL	németeket
apátnőknél	pos=N,case=IN+ALL,num=PL	apátnőkbe
akadálynak	pos=N,case=ON+ALL,num=SG	akadályra
alosztályokhoz	pos=N,case=TRANS,num=PL	alosztályokká
észtekről	pos=N,case=FRML,num=PL	észtekként
sebtapasz	pos=N,case=ACC,num=PL	sebtapaszokat
díja	pos=N,case=ON+ALL,num=PL	díjakra
alapig	pos=N,case=FRML,num=PL	alapokként
szállásig	pos=N,case=ABL,num=PL	szállásoktól
fakírban	pos=N,case=NOM,num=PL	fakírok
ógörögökről	pos=N,case=AT+ESS,num=SG	ógörögnél
baskírként	pos=N,case=ACC,num=PL	baskírokat
végekké	pos=N,case=ALL,num=PL	végekhez
feleségből	pos=N,case=ABL,num=PL	feleségektől
ajándékaitok	pos=N,case=ON+ESS,num=SG	ajándékon
céljaitok	pos=N,case=ON+ALL,num=PL	célokra
varrónőre	pos=N,case=IN+ABL,num=SG	varrónőből
feleségekként	pos=N,case=ABL,num=SG	feleségtől
ösztöndíjakul	pos=N,case=PRP,num=SG	ösztöndíjért
nevelőnőnél	pos=N,case=BYWAY,num=SG	nevelőnőül
ajándékaid	pos=N,case=ON+ABL,num=SG	ajándékról
megállapodás	pos=N,case=ON+ALL,num=SG	megállapodásra
végeik	pos=N,case=ACC,num=PL	végeket
válaszra	pos=N,case=DAT,num=PL	válaszoknak
bázisnak	pos=N,case=ABL,num=PL	bázisoktól
végekért	pos=N,case=ABL,num=PL	végektől
tudomásokért	pos=N,case=ON+ABL,num=SG	tudomásról
bizonyíték	pos=N,case=INS,num=SG	bizonyítékkal
vízikutyává	pos=N,case=IN+ABL,num=SG	vízikutyából
khmerek	pos=N,case=BYWAY,num=SG	khmerül
könyvtárosnőbe	pos=N,case=TERM,num=PL	könyvtárosnőkig
hollandokért	pos=N,case=TRANS,num=SG	hollanddá
szállásként	pos=N,case=DAT,num=PL	szállásoknak
döntéshez	pos=N,case=ACC,num=SG	döntést
ürügyek	pos=N,case=ALL,num=SG	ürügyhez
baskírotok	pos=N,case=INS,num=SG	baskírral
japánoktól	pos=N,case=ABL,num=SG	japántól
apácafőnöknővé	pos=N,case=IN+ESS,num=PL	apácafőnöknőkben
arcaink	pos=N,case=FRML,num=PL	arcokként
útpadkával	pos=N,case=BYWAY,num=SG	útpadkául
ajándékból	pos=N,case=IN+ABL,num=PL	ajándékokból
nevelőnőknek	pos=N,case=ABL,num=SG	nevelőnőtől
tulajdonosnőik	pos=N,case=IN+ALL,num=PL	tulajdonosnőkbe
végeket	pos=N,case=NOM,num=SG	vég
nevelőnői	pos=N,case=AT+ESS,num=SG	nevelőnőnél
tanítványa	pos=N,case=AT+ESS,num=PL	tanítványoknál
nevelőnővé	pos=N,case=BYWAY,num=SG	nevelőnőül
baskírokként	pos=N,case=IN+ALL,num=PL	baskírokba
japánom	pos=N,case=NOM,num=PL	japánok
természetül	pos=N,case=FRML,num=SG	természetként
halmaz	pos=N,case=ALL,num=SG	halmazhoz
bizonyítékokkal	pos=N,case=BYWAY,num=PL	bizonyítékokul
elismeréshez	pos=N,case=DAT,num=PL	elismeréseknek
fejedelmekért	pos=N,case=PRP,num=SG	fejedelemért
kertekben	pos=N,case=IN+ABL,num=PL	kertekből
alosztályokról	pos=N,case=PRP,num=SG	alosztályért
bizonyítékba	pos=N,case=TERM,num=PL	bizonyítékokig
vízikutyái	pos=N,case=ACC,num=SG	vízikutyát
alapon	pos=N,case=TERM,num=PL	alapokig
tudomásai	pos=N,case=FRML,num=PL	tudomásokként
ágytálba	pos=N,case=TRANS,num=SG	ágytállá
példaképpel	pos=N,case=ACC,num=PL	példaképeket
rendelkezésnél	pos=N,case=BYWAY,num=SG	rendelkezésül
megállapodásokra	pos=N,case=INS,num=PL	megállapodásokkal
úrnőd	pos=N,case=NOM,num=SG	úrnő
arabnak	pos=N,case=BYWAY,num=SG	arabul
alapokon	pos=N,case=IN+ABL,num=PL	alapokból
fakírral	pos=N,case=ACC,num=PL	fakírokat
kurdoknál	pos=N,case=NOM,num=PL	kurdok
tanítványra	pos=N,case=PRP,num=PL	tanítványokért
arabokká	pos=N,case=ON+ABL,num=PL	arabokról
hozományoknak	pos=N,case=ABL,num=SG	hozománytól
megállapodásként	pos=N,case=NOM,num=SG	megállapodás
nagydíjakban	pos=N,case=IN+ALL,num=SG	nagydíjba
feleségek	pos=N,case=IN+ABL,num=PL	feleségekből
arcod	pos=N,case=ON+ABL,num=PL	arcokról
baskírról	pos=N,case=ABL,num=PL	baskíroktól
végük	pos=N,case=PRP,num=SG	végért
őreitek	pos=N,case=BYWAY,num=SG	őrül
útpadkákként	pos=N,case=AT+ESS,num=SG	útpadkánál
ösztöndíjaink	pos=N,case=INS,num=PL	ösztöndíjakkal
szabályozást	pos=N,case=ALL,num=PL	szabályozásokhoz
adatból	pos=N,case=ON+ESS,num=SG	adaton
árindexekből	pos=N,case=PRP,num=SG	árindexért
tudomásod	pos=N,case=FRML,num=PL	tudomásokként
útpadkák	pos=N,case=BYWAY,num=SG	útpadkául
szabályozásként	pos=N,case=ACC,num=PL	szabályozásokat
bizonyítéktól	pos=N,case=TRANS,num=PL	bizonyítékokká
törzsem	pos=N,case=NOM,num=PL	törzsek
tulajdonosnőket	pos=N,case=IN+ALL,num=SG	tulajdonosnőbe
halmazig	pos=N,case=ON+ABL,num=PL	halmazokról
akadályba	pos=N,case=NOM,num=PL	akadályok
díjam	pos=N,case=ACC,num=SG	díjat
szállásért	pos=N,case=FRML,num=PL	szállásokként
apátnőm	pos=N,case=BYWAY,num=SG	apátnőül
célponton	pos=N,case=ALL,num=SG	célponthoz
nevelőnőn	pos=N,case=TRANS,num=PL	nevelőnőkké
portugálokat	pos=N,case=DAT,num=SG	portugálnak
bosnyákokban	pos=N,case=INS,num=SG	bosnyákkal
dísztől	pos=N,case=AT+ESS,num=PL	díszeknél
példán	pos=N,case=ON+ABL,num=SG	példáról
németért	pos=N,case=ALL,num=PL	németekhez
fejedelemként	pos=N,case=TERM,num=SG	fejedelemig
feleségekre	pos=N,case=NOM,num=PL	feleségek
mentségeknek	pos=N,case=ACC,num=SG	mentséget
nagydíjakról	pos=N,case=ON+ESS,num=SG	nagydíjon
eszménynek	pos=N,case=ON+ALL,num=SG	eszményre
alosztályokban	pos=N,case=ABL,num=SG	alosztálytól
választól	pos=N,case=NOM,num=PL	válaszok
magyarod	pos=N,case=DAT,num=SG	magyarnak
arccal	pos=N,case=ON+ESS,num=PL	arcokon
díjra	pos=N,case=IN+ESS,num=SG	díjban
elismerésekkel	pos=N,case=INS,num=SG	elismeréssel
halmazod	pos=N,case=FRML,num=PL	halmazokként
adományoknál	pos=N,case=DAT,num=PL	adományoknak
sógornőik	pos=N,case=IN+ABL,num=PL	sógornőkből
rendelkezésről	pos=N,case=ON+ALL,num=PL	rendelkezésekre
portugálokat	pos=N,case=IN+ESS,num=PL	portugálokban
apácafőnöknőben	pos=N,case=TRANS,num=SG	apácafőnöknővé
észtekért	pos=N,case=ON+ESS,num=PL	észteken
könyvtárosnője	pos=N,case=PRP,num=PL	könyvtárosnőkért
díjakig	pos=N,case=PRP,num=PL	díjakért
őreid	pos=N,case=ALL,num=PL	őrökhöz
bosnyákjaik	pos=N,case=FRML,num=PL	bosnyákokként
magyarokig	pos=N,case=ON+ALL,num=PL	magyarokra
tanítványaik	pos=N,case=ABL,num=SG	tanítványtól
célja	pos=N,case=DAT,num=SG	célnak
rendelkezéseid	pos=N,case=DAT,num=SG	rendelkezésnek
eszményről	pos=N,case=TRANS,num=PL	eszményekké
apátnőnk	pos=N,case=ON+ALL,num=SG	apátnőre
portugálokkal	pos=N,case=ABL,num=SG	portugáltól
bizonyítékokul	pos=N,case=ON+ALL,num=SG	bizonyítékra
németül	pos=N,case=TERM,num=SG	németig
feleségért	pos=N,case=IN+ABL,num=PL	feleségekből
szállással	pos=N,case=ON+ESS,num=SG	szálláson
megállapodásaim	pos=N,case=TRANS,num=SG	megállapodássá
alapunk	pos=N,case=ABL,num=SG	alaptól
törzsed	pos=N,case=ABL,num=PL	törzsektől
őrökbe	pos=N,case=NOM,num=PL	őrök
sógornőnél	pos=N,case=ALL,num=PL	sógornőkhöz
alosztályokhoz	pos=N,case=ACC,num=PL	alosztályokat
célponttól	pos=N,case=ON+ALL,num=PL	célpontokra
baskíroktól	pos=N,case=DAT,num=SG	baskírnak
mentségeken	pos=N,case=FRML,num=PL	mentségekként
halmazként	pos=N,case=INS,num=SG	halmazzal
ajándékokból	pos=N,case=TRANS,num=SG	ajándékká
bővítéseknél	pos=N,case=TERM,num=PL	bővítésekig
rendőrnőről	pos=N,case=INS,num=SG	rendőrnővel
észttel	pos=N,case=IN+ESS,num=PL	észtekben
nevelőnőktől	pos=N,case=ON+ALL,num=PL	nevelőnőkre
tudomásotok	pos=N,case=AT+ESS,num=SG	tudomásnál
osztályokat	pos=N,case=ON+ESS,num=PL	osztályokon
apácafőnöknőik	pos=N,case=ACC,num=SG	apácafőnöknőt
alosztályokhoz	pos=N,case=AT+ESS,num=PL	alosztályoknál
rendelkezésekig	pos=N,case=ON+ALL,num=SG	rendelkezésre
hollandba	pos=N,case=ON+ABL,num=PL	hollandokról
ágytálat	pos=N,case=INS,num=SG	ágytállal
természetük	pos=N,case=ACC,num=SG	természetet
apátnőd	pos=N,case=AT+ESS,num=PL	apátnőknél
apátnőtől	pos=N,case=TRANS,num=PL	apátnőkké
ösztöndíjba	pos=N,case=ON+ALL,num=PL	ösztöndíjakra
bázisom	pos=N,case=ACC,num=SG	bázist
sebtapaszai	pos=N,case=ALL,num=PL	sebtapaszokhoz
fejedelmekké	pos=N,case=DAT,num=SG	fejedelemnek
flamandon	pos=N,case=TERM,num=SG	flamandig
tanítványra	pos=N,case=AT+ESS,num=PL	tanítványoknál
fakíroktól	pos=N,case=IN+ABL,num=SG	fakírból
rendelkezésed	pos=N,case=IN+ABL,num=PL	rendelkezésekből
alosztályaink	pos=N,case=ON+ALL,num=PL	alosztályokra
válaszoknak	pos=N,case=TRANS,num=PL	válaszokká
flamandot	pos=N,case=ON+ALL,num=SG	flamandra
nyenyecről	pos=N,case=IN+ABL,num=PL	nyenyecekből
nagydíjakról	pos=N,case=TERM,num=PL	nagydíjakig
vánkosra	pos=N,case=ON+ALL,num=PL	vánkosokra
angolba	pos=N,case=ALL,num=SG	angolhoz
díjakig	pos=N,case=ON+ABL,num=SG	díjról
sógornőnek	pos=N,case=FRML,num=SG	sógornőként
hollandod	pos=N,case=BYWAY,num=SG	hollandul
adományunk	pos=N,case=ON+ESS,num=PL	adományokon
ösztöndíjuk	pos=N,case=NOM,num=PL	ösztöndíjak
ágytáluk	pos=N,case=ON+ESS,num=SG	ágytálon
kertként	pos=N,case=IN+ESS,num=PL	kertekben
bázisokhoz	pos=N,case=FRML,num=PL	bázisokként
ürügyek	pos=N,case=ON+ALL,num=SG	ürügyre
varrónője	pos=N,case=DAT,num=PL	varrónőknek
nevelőnőig	pos=N,case=INS,num=PL	nevelőnőkkel
ágytálnál	pos=N,case=ON+ABL,num=PL	ágytálakról
eszménye	pos=N,case=PRP,num=PL	eszményekért
rendőrnővel	pos=N,case=ABL,num=SG	rendőrnőtől
szállásnak	pos=N,case=TRANS,num=PL	szállásokká
könyvtárosnőkké	pos=N,case=ON+ABL,num=PL	könyvtárosnőkről
ágytálért	pos=N,case=ON+ALL,num=SG	ágytálra
mentséggel	pos=N,case=IN+ABL,num=SG	mentségből
úrnőnk	pos=N,case=TRANS,num=SG	úrnővé
ágytálért	pos=N,case=AT+ESS,num=SG	ágytálnál
eszményeken	pos=N,case=ABL,num=PL	eszményektől
válasza	pos=N,case=ACC,num=PL	válaszokat
szabályozásoknál	pos=N,case=BYWAY,num=SG	szabályozásul
tanítványhoz	pos=N,case=PRP,num=SG	tanítványért
flamandjaik	pos=N,case=BYWAY,num=SG	flamandul
akadályt	pos=N,case=ON+ALL,num=PL	akadályokra
útpadkában	pos=N,case=IN+ALL,num=PL	útpadkákba
lengyel	pos=N,case=IN+ABL,num=PL	lengyelekből
díjat	pos=N,case=IN+ALL,num=SG	díjba
hozományuk	pos=N,case=PRP,num=SG	hozományért
döntéseik	pos=N,case=IN+ESS,num=SG	döntésben
bizonyítékon	pos=N,case=FRML,num=PL	bizonyítékokként
bázisoknál	pos=N,case=FRML,num=SG	bázisként
osztállyal	pos=N,case=IN+ALL,num=SG	osztályba
apátnőkről	pos=N,case=IN+ABL,num=PL	apátnőkből
lengyelei	pos=N,case=IN+ABL,num=SG	lengyelből
lengyelünk	pos=N,case=FRML,num=SG	lengyelként
rendelkezést	pos=N,case=ON+ABL,num=PL	rendelkezésekről
döntései	pos=N,case=TERM,num=PL	döntésekig
japánokkal	pos=N,case=ON+ALL,num=SG	japánra
döntésekké	pos=N,case=IN+ABL,num=PL	döntésekből
alosztályokként	pos=N,case=IN+ALL,num=SG	alosztályba
angolom	pos=N,case=TRANS,num=PL	angolokká
bizonyítékokba	pos=N,case=INS,num=SG	bizonyítékkal
lengyelekkel	pos=N,case=ALL,num=SG	lengyelhez
eszményről	pos=N,case=DAT,num=SG	eszménynek
vízikutyákig	pos=N,case=IN+ABL,num=SG	vízikutyából
árindexeim	pos=N,case=ALL,num=PL	árindexekhez
remeknél	pos=N,case=TERM,num=SG	remekig
példára	pos=N,case=PRP,num=PL	példákért
khmerekkel	pos=N,case=FRML,num=SG	khmerként
akadályokban	pos=N,case=DAT,num=PL	akadályoknak
célpontokba	pos=N,case=IN+ESS,num=PL	célpontokban
tudomásul	pos=N,case=DAT,num=SG	tudomásnak
árindexül	pos=N,case=AT+ESS,num=SG	árindexnél
díszhez	pos=N,case=ABL,num=SG	dísztől
arcokba	pos=N,case=PRP,num=SG	arcért
árindexekről	pos=N,case=IN+ALL,num=PL	árindexekbe
hozományig	pos=N,case=ABL,num=PL	hozományoktól
sógornőhöz	pos=N,case=INS,num=SG	sógornővel
kerteken	pos=N,case=NOM,num=SG	kert
sógornőkről	pos=N,case=PRP,num=SG	sógornőért
természetekké	pos=N,case=DAT,num=PL	természeteknek
törzse	pos=N,case=IN+ABL,num=PL	törzsekből
ösztöndíjakról	pos=N,case=FRML,num=SG	ösztöndíjként
japánotok	pos=N,case=DAT,num=PL	japánoknak
díjakhoz	pos=N,case=ON+ABL,num=PL	díjakról
ösztöndíjakkal	pos=N,case=TRANS,num=PL	ösztöndíjakká
arcotok	pos=N,case=ON+ABL,num=SG	arcról
bosnyákod	pos=N,case=IN+ALL,num=PL	bosnyákokba
kertről	pos=N,case=IN+ABL,num=PL	kertekből
példáid	pos=N,case=BYWAY,num=SG	például
apácafőnöknő	pos=N,case=FRML,num=PL	apácafőnöknőkként
baskírnak	pos=N,case=IN+ABL,num=PL	baskírokból
megállapodásaink	pos=N,case=ACC,num=SG	megállapodást
példáknak	pos=N,case=FRML,num=PL	példákként
bosnyákká	pos=N,case=ON+ALL,num=SG	bosnyákra
apátnőnk	pos=N,case=ALL,num=PL	apátnőkhöz
őröknél	pos=N,case=ABL,num=SG	őrtől
ágytálban	pos=N,case=IN+ABL,num=PL	ágytálakból
könyvtárosnőül	pos=N,case=IN+ESS,num=PL	könyvtárosnőkben
arcokban	pos=N,case=ON+ALL,num=SG	arcra
sógornőnek	pos=N,case=IN+ESS,num=PL	sógornőkben
példákig	pos=N,case=DAT,num=PL	példáknak
halmazoktól	pos=N,case=ON+ABL,num=PL	halmazokról
khmernek	pos=N,case=ABL,num=SG	khmertől
árindexük	pos=N,case=ON+ALL,num=SG	árindexre
adományhoz	pos=N,case=IN+ESS,num=PL	adományokban
bővítésekké	pos=N,case=INS,num=PL	bővítésekkel
fejedelmem	pos=N,case=BYWAY,num=SG	fejedelemül
útpadkától	pos=N,case=ALL,num=SG	útpadkához
rendelkezéssel	pos=N,case=ON+ABL,num=PL	rendelkezésekről
khmerekhez	pos=N,case=INS,num=PL	khmerekkel
baskírjuk	pos=N,case=ACC,num=SG	baskírt
kutyában	pos=N,case=ON+ESS,num=PL	kutyákon
akadályuk	pos=N,case=AT+ESS,num=PL	akadályoknál
törzsről	pos=N,case=ALL,num=SG	törzshöz
megállapodása	pos=N,case=ON+ESS,num=SG	megállapodáson
németül	pos=N,case=TERM,num=PL	németekig
alapul	pos=N,case=TRANS,num=PL	alapokká
alosztályt	pos=N,case=AT+ESS,num=SG	alosztálynál
ágytálaik	pos=N,case=AT+ESS,num=SG	ágytálnál
hozományokat	pos=N,case=TRANS,num=PL	hozományokká
nagydíjakként	pos=N,case=ABL,num=PL	nagydíjaktól
hollandotok	pos=N,case=ACC,num=SG	hollandot
angolokkal	pos=N,case=IN+ABL,num=SG	angolból
célpontokba	pos=N,case=BYWAY,num=SG	célpontul
fejedelme	pos=N,case=FRML,num=PL	fejedelmekként
alosztályuk	pos=N,case=BYWAY,num=SG	alosztályul
németbe	pos=N,case=PRP,num=PL	németekért
baskírokért	pos=N,case=PRP,num=SG	baskírért
fejedelmektől	pos=N,case=FRML,num=SG	fejedelemként
ágytálakba	pos=N,case=FRML,num=SG	ágytálként
nyenyecért	pos=N,case=TERM,num=PL	nyenyecekig
könyvtárosnő	pos=N,case=ACC,num=SG	könyvtárosnőt
céllá	pos=N,case=ABL,num=SG	céltól
díjakban	pos=N,case=ON+ALL,num=PL	díjakra
mentségeink	pos=N,case=FRML,num=SG	mentségként
díjad	pos=N,case=IN+ABL,num=PL	díjakból
fejedelem	pos=N,case=FRML,num=SG	fejedelemként
adatnál	pos=N,case=TRANS,num=PL	adatokká
sebtapaszaim	pos=N,case=DAT,num=SG	sebtapasznak
apácafőnöknőtől	pos=N,case=BYWAY,num=SG	apácafőnöknőül
tanítványon	pos=N,case=FRML,num=SG	tanítványként
feleségei	pos=N,case=PRP,num=SG	feleségért
szabályozásaink	pos=N,case=PRP,num=SG	szabályozásért
bázisokért	pos=N,case=PRP,num=SG	bázisért
könyvtárosnőtől	pos=N,case=AT+ESS,num=SG	könyvtárosnőnél
díjakból	pos=N,case=IN+ESS,num=PL	díjakban
törzsekhez	pos=N,case=IN+ALL,num=PL	törzsekbe
kutyáitok	pos=N,case=IN+ESS,num=SG	kutyában
ógörögökkel	pos=N,case=IN+ESS,num=PL	ógörögökben
bázistól	pos=N,case=ON+ABL,num=PL	bázisokról
hollandot	pos=N,case=IN+ALL,num=SG	hollandba
khmerrel	pos=N,case=IN+ESS,num=PL	khmerekben
végeken	pos=N,case=TERM,num=SG	végig
khmerek	pos=N,case=ON+ESS,num=PL	khmereken
lengyelünk	pos=N,case=ON+ESS,num=SG	lengyelen
németeitek	pos=N,case=IN+ESS,num=PL	németekben
némethez	pos=N,case=FRML,num=SG	németként
eszményekké	pos=N,case=IN+ESS,num=PL	eszményekben
megállapodásért	pos=N,case=TERM,num=PL	megállapodásokig
kertként	pos=N,case=NOM,num=SG	kert
vánkosokként	pos=N,case=ON+ABL,num=SG	vánkosról
természeten	pos=N,case=IN+ABL,num=PL	természetekből
khmernek	pos=N,case=ACC,num=PL	khmereket
megállapodásoktól	pos=N,case=ON+ESS,num=PL	megállapodásokon
őreim	pos=N,case=TRANS,num=SG	őrré
bázisoknál	pos=N,case=ON+ABL,num=SG	bázisról
törzsei	pos=N,case=IN+ESS,num=SG	törzsben
varrónőkig	pos=N,case=FRML,num=PL	varrónőkként
sebtapaszaim	pos=N,case=AT+ESS,num=PL	sebtapaszoknál
remekeken	pos=N,case=ABL,num=PL	remekektől
díszért	pos=N,case=ACC,num=PL	díszeket
észtért	pos=N,case=TRANS,num=SG	észtté
varrónőről	pos=N,case=ON+ABL,num=PL	varrónőkről
kutya	pos=N,case=INS,num=PL	kutyákkal
fejedelemre	pos=N,case=ON+ABL,num=PL	fejedelmekről
arabod	pos=N,case=TRANS,num=SG	arabbá
szabályozásból	pos=N,case=TERM,num=PL	szabályozásokig
bővítésekből	pos=N,case=AT+ESS,num=PL	bővítéseknél
adományból	pos=N,case=AT+ESS,num=SG	adománynál
vízikutyáért	pos=N,case=IN+ESS,num=SG	vízikutyában
ógörögért	pos=N,case=IN+ABL,num=SG	ógörögből
vánkosoktól	pos=N,case=PRP,num=PL	vánkosokért
apácafőnöknő	pos=N,case=FRML,num=SG	apácafőnöknőként
céljuk	pos=N,case=BYWAY,num=SG	célul
kertként	pos=N,case=PRP,num=SG	kertért
döntései	pos=N,case=FRML,num=SG	döntésként
kutyáid	pos=N,case=ABL,num=PL	kutyáktól
célponttól	pos=N,case=FRML,num=PL	célpontokként
ürügyeid	pos=N,case=FRML,num=PL	ürügyekként
feleségeknél	pos=N,case=ACC,num=SG	feleséget
fakírjaitok	pos=N,case=TERM,num=SG	fakírig
halmazok	pos=N,case=DAT,num=PL	halmazoknak
lengyele	pos=N,case=ALL,num=PL	lengyelekhez
hozományokat	pos=N,case=IN+ABL,num=SG	hozományból
eszményeim	pos=N,case=PRP,num=PL	eszményekért
rendelkezésekben	pos=N,case=ACC,num=PL	rendelkezéseket
tulajdonosnőből	pos=N,case=DAT,num=SG	tulajdonosnőnek
lengyelbe	pos=N,case=ON+ESS,num=SG	lengyelen
ajándékokkal	pos=N,case=INS,num=SG	ajándékkal
mentségtől	pos=N,case=IN+ABL,num=SG	mentségből
varrónőn	pos=N,case=TERM,num=PL	varrónőkig
angolja	pos=N,case=ALL,num=SG	angolhoz
tanítványokig	pos=N,case=ON+ALL,num=PL	tanítványokra
alapként	pos=N,case=IN+ABL,num=PL	alapokból
szállást	pos=N,case=IN+ESS,num=PL	szállásokban
vízikutyák	pos=N,case=TRANS,num=PL	vízikutyákká
baskírokig	pos=N,case=BYWAY,num=SG	baskírul
ürügyünk	pos=N,case=IN+ESS,num=SG	ürügyben
baskír	pos=N,case=ON+ALL,num=PL	baskírokra
németeknek	pos=N,case=ABL,num=PL	németektől
magyarul	pos=N,case=ON+ABL,num=PL	magyarokról
árindexre	pos=N,case=ON+ESS,num=SG	árindexen
bővítéseken	pos=N,case=TRANS,num=PL	bővítésekké
bosnyákokba	pos=N,case=DAT,num=SG	bosnyáknak
példaképem	pos=N,case=BYWAY,num=SG	példaképül
bővítésként	pos=N,case=ACC,num=PL	bővítéseket
célpontot	pos=N,case=FRML,num=SG	célpontként
khmereknél	pos=N,case=IN+ABL,num=PL	khmerekből
japánról	pos=N,case=INS,num=SG	japánnal
japánból	pos=N,case=IN+ESS,num=SG	japánban
alosztályt	pos=N,case=IN+ESS,num=PL	alosztályokban
kurdról	pos=N,case=FRML,num=SG	kurdként
ürügyem	pos=N,case=ON+ESS,num=SG	ürügyen
németeknek	pos=N,case=ALL,num=SG	némethez
adományhoz	pos=N,case=ON+ALL,num=SG	adományra
ürügy	pos=N,case=IN+ABL,num=PL	ürügyekből
fejedelemnek	pos=N,case=INS,num=PL	fejedelmekkel
angoljaim	pos=N,case=ON+ABL,num=SG	angolról
ösztöndíjként	pos=N,case=IN+ESS,num=PL	ösztöndíjakban
mentségül	pos=N,case=IN+ALL,num=SG	mentségbe
adományokon	pos=N,case=TRANS,num=SG	adománnyá
válaszokként	pos=N,case=NOM,num=SG	válasz
adományaim	pos=N,case=ABL,num=PL	adományoktól
rendőrnőkkel	pos=N,case=ON+ABL,num=PL	rendőrnőkről
remeken	pos=N,case=AT+ESS,num=PL	remekeknél
válaszokként	pos=N,case=TERM,num=PL	válaszokig
arabjai	pos=N,case=IN+ABL,num=PL	arabokból
törzseim	pos=N,case=INS,num=PL	törzsekkel
rendelkezésekért	pos=N,case=DAT,num=SG	rendelkezésnek
ágytálakért	pos=N,case=IN+ALL,num=SG	ágytálba
ágytálon	pos=N,case=ACC,num=PL	ágytálakat
tulajdonosnőkbe	pos=N,case=NOM,num=PL	tulajdonosnők
díszeitek	pos=N,case=IN+ALL,num=PL	díszekbe
elismerésből	pos=N,case=FRML,num=PL	elismerésekként
vánkosokból	pos=N,case=DAT,num=SG	vánkosnak
akadályai	pos=N,case=ACC,num=SG	akadályt
kutyáink	pos=N,case=DAT,num=SG	kutyának
vízikutyáig	pos=N,case=NOM,num=PL	vízikutyák
ösztöndíjakhoz	pos=N,case=IN+ESS,num=SG	ösztöndíjban
szabályozásokról	pos=N,case=BYWAY,num=SG	szabályozásul
példaképekért	pos=N,case=DAT,num=PL	példaképeknek
elismerésekbe	pos=N,case=ABL,num=PL	elismerésektől
halmaz	pos=N,case=ACC,num=SG	halmazt
példaképeknek	pos=N,case=TRANS,num=SG	példaképpé
kutyáknak	pos=N,case=ACC,num=SG	kutyát
hollandjaim	pos=N,case=IN+ALL,num=PL	hollandokba
fakírként	pos=N,case=NOM,num=PL	fakírok
khmeretek	pos=N,case=TERM,num=SG	khmerig
bővítésem	pos=N,case=IN+ALL,num=SG	bővítésbe
portugálokból	pos=N,case=ALL,num=SG	portugálhoz
kutyákkal	pos=N,case=IN+ESS,num=SG	kutyában
fakírból	pos=N,case=IN+ALL,num=PL	fakírokba
árindexről	pos=N,case=ON+ABL,num=PL	árindexekről
ajándékul	pos=N,case=PRP,num=SG	ajándékért
elismeréseitek	pos=N,case=IN+ABL,num=PL	elismerésekből
célok	pos=N,case=PRP,num=SG	célért
angoljaink	pos=N,case=IN+ALL,num=PL	angolokba
ágytálakban	pos=N,case=BYWAY,num=SG	ágytálul
vízikutyához	pos=N,case=IN+ALL,num=SG	vízikutyába
őrökről	pos=N,case=IN+ESS,num=PL	őrökben
alosztállyal	pos=N,case=TRANS,num=PL	alosztályokká
rendelkezésekhez	pos=N,case=IN+ALL,num=SG	rendelkezésbe
khmerhez	pos=N,case=INS,num=SG	khmerrel
magyarról	pos=N,case=FRML,num=PL	magyarokként
példaképnek	pos=N,case=PRP,num=PL	példaképekért
angol	pos=N,case=INS,num=SG	angollal
tanítványotok	pos=N,case=DAT,num=SG	tanítványnak
flamandjaitok	pos=N,case=ON+ESS,num=PL	flamandokon
mentségbe	pos=N,case=ON+ESS,num=PL	mentségeken
mentségnek	pos=N,case=ABL,num=SG	mentségtől
kertjeim	pos=N,case=ON+ESS,num=SG	kerten
ürügyig	pos=N,case=ABL,num=PL	ürügyektől
tanítványul	pos=N,case=ON+ESS,num=SG	tanítványon
kutyáik	pos=N,case=ACC,num=SG	kutyát
hollandért	pos=N,case=ON+ABL,num=PL	hollandokról
japánokban	pos=N,case=ON+ESS,num=SG	japánon
megállapodásokba	pos=N,case=NOM,num=PL	megállapodások
remekeik	pos=N,case=NOM,num=SG	remek
sógornőről	pos=N,case=IN+ALL,num=SG	sógornőbe
válaszban	pos=N,case=AT+ESS,num=PL	válaszoknál
adatokra	pos=N,case=ACC,num=PL	adatokat
akadályai	pos=N,case=ON+ESS,num=PL	akadályokon
nevelőnőből	pos=N,case=IN+ALL,num=SG	nevelőnőbe
halmazokig	pos=N,case=ON+ALL,num=SG	halmazra
angolod	pos=N,case=ABL,num=SG	angoltól
tudomásra	pos=N,case=BYWAY,num=SG	tudomásul
hozományról	pos=N,case=IN+ABL,num=SG	hozományból
példaképük	pos=N,case=IN+ALL,num=SG	példaképbe
természetekként	pos=N,case=TERM,num=SG	természetig
ajándékaid	pos=N,case=INS,num=PL	ajándékokkal
bázis	pos=N,case=BYWAY,num=PL	bázisokul
halmazokban	pos=N,case=TERM,num=PL	halmazokig
fakírjaink	pos=N,case=NOM,num=PL	fakírok
bázisokként	pos=N,case=ACC,num=SG	bázist
khmerért	pos=N,case=IN+ESS,num=PL	khmerekben
célokért	pos=N,case=ACC,num=SG	célt
bizonyítéktól	pos=N,case=DAT,num=PL	bizonyítékoknak
célpontokon	pos=N,case=PRP,num=SG	célpontért
úrnőért	pos=N,case=INS,num=PL	úrnőkkel
fejedelemhez	pos=N,case=TERM,num=PL	fejedelmekig
hollandjaik	pos=N,case=AT+ESS,num=SG	hollandnál
ajándékokért	pos=N,case=NOM,num=SG	ajándék
eszményeitek	pos=N,case=DAT,num=PL	eszményeknek
nyenyeceknek	pos=N,case=NOM,num=PL	nyenyecek
adományokkal	pos=N,case=ABL,num=PL	adományoktól
célnál	pos=N,case=ACC,num=PL	célokat
tudomásokhoz	pos=N,case=AT+ESS,num=PL	tudomásoknál
szállásokig	pos=N,case=IN+ESS,num=PL	szállásokban
szabályozásért	pos=N,case=ABL,num=SG	szabályozástól
tanítványunk	pos=N,case=DAT,num=PL	tanítványoknak
útpadkájuk	pos=N,case=IN+ESS,num=PL	útpadkákban
őrként	pos=N,case=IN+ESS,num=PL	őrökben
törzsben	pos=N,case=ON+ALL,num=PL	törzsekre
példából	pos=N,case=IN+ALL,num=SG	példába
arabokat	pos=N,case=ACC,num=SG	arabot
hollandja	pos=N,case=NOM,num=SG	holland
alosztályok	pos=N,case=ACC,num=SG	alosztályt
szállásokra	pos=N,case=ON+ABL,num=SG	szállásról
törzsekig	pos=N,case=INS,num=SG	törzzsel
döntésekért	pos=N,case=IN+ABL,num=PL	döntésekből
lengyeleket	pos=N,case=IN+ABL,num=SG	lengyelből
példákban	pos=N,case=TRANS,num=SG	példává
nagydíjakért	pos=N,case=IN+ALL,num=SG	nagydíjba
könyvtárosnőre	pos=N,case=PRP,num=PL	könyvtárosnőkért
hozományom	pos=N,case=IN+ALL,num=PL	hozományokba
angolban	pos=N,case=ON+ABL,num=PL	angolokról
bizonyítékokká	pos=N,case=TERM,num=PL	bizonyítékokig
fakírjaim	pos=N,case=IN+ESS,num=SG	fakírban
eszménye	pos=N,case=ABL,num=SG	eszménytől
útpadkáknak	pos=N,case=IN+ESS,num=SG	útpadkában
bázisuk	pos=N,case=IN+ABL,num=PL	bázisokból
ürügyekbe	pos=N,case=ABL,num=SG	ürügytől
apácafőnöknőknek	pos=N,case=ABL,num=PL	apácafőnöknőktől
könyvtárosnőkön	pos=N,case=FRML,num=PL	könyvtárosnőkként
ürügyei	pos=N,case=IN+ABL,num=PL	ürügyekből
természetnek	pos=N,case=ON+ALL,num=PL	természetekre
megállapodásként	pos=N,case=IN+ESS,num=SG	megállapodásban
portugálok	pos=N,case=ON+ESS,num=PL	portugálokon
eszményért	pos=N,case=INS,num=PL	eszményekkel
magyart	pos=N,case=NOM,num=SG	magyar
nyenyecük	pos=N,case=INS,num=PL	nyenyecekkel
akadállyá	pos=N,case=ALL,num=PL	akadályokhoz
tulajdonosnőt	pos=N,case=ALL,num=SG	tulajdonosnőhöz
fakírban	pos=N,case=AT+ESS,num=SG	fakírnál
döntéstől	pos=N,case=INS,num=SG	döntéssel
kertjeik	pos=N,case=PRP,num=SG	kertért
fakírod	pos=N,case=DAT,num=PL	fakíroknak
halmazokért	pos=N,case=BYWAY,num=PL	halmazokul
kurdra	pos=N,case=PRP,num=PL	kurdokért
flamandoktól	pos=N,case=FRML,num=PL	flamandokként
nyenyecért	pos=N,case=ABL,num=PL	nyenyecektől
akadályokról	pos=N,case=IN+ABL,num=SG	akadályból
szállásokra	pos=N,case=IN+ESS,num=PL	szállásokban
németetek	pos=N,case=ON+ALL,num=SG	németre
fejedelmei	pos=N,case=IN+ABL,num=SG	fejedelemből
alapból	pos=N,case=IN+ESS,num=SG	alapban
arabjuk	pos=N,case=PRP,num=SG	arabért
szabályozásokat	pos=N,case=IN+ESS,num=PL	szabályozásokban
arabokból	pos=N,case=ACC,num=PL	arabokat
törzstől	pos=N,case=TRANS,num=PL	törzsekké
példákká	pos=N,case=ALL,num=SG	példához
tudomásaitok	pos=N,case=BYWAY,num=SG	tudomásul
magyarul	pos=N,case=INS,num=PL	magyarokkal
rendőrnőre	pos=N,case=INS,num=PL	rendőrnőkkel
apátnőbe	pos=N,case=ON+ALL,num=SG	apátnőre
alosztályaid	pos=N,case=ACC,num=PL	alosztályokat
portugálban	pos=N,case=ON+ALL,num=PL	portugálokra
akadályhoz	pos=N,case=INS,num=SG	akadállyal
ajándékba	pos=N,case=IN+ABL,num=PL	ajándékokból
mentségül	pos=N,case=ABL,num=SG	mentségtől
vánkost	pos=N,case=IN+ABL,num=PL	vánkosokból
bosnyákokhoz	pos=N,case=IN+ALL,num=SG	bosnyákba
ágytálhoz	pos=N,case=ON+ABL,num=PL	ágytálakról
németük	pos=N,case=ON+ABL,num=PL	németekről
japánokként	pos=N,case=IN+ESS,num=PL	japánokban
úrnője	pos=N,case=ON+ALL,num=SG	úrnőre
vánkosokkal	pos=N,case=NOM,num=PL	vánkosok
alosztályban	pos=N,case=PRP,num=PL	alosztályokért
adományhoz	pos=N,case=NOM,num=PL	adományok
törzsekké	pos=N,case=ON+ESS,num=PL	törzseken
sógornők	pos=N,case=AT+ESS,num=PL	sógornőknél
célpontba	pos=N,case=IN+ESS,num=PL	célpontokban
hozományokig	pos=N,case=NOM,num=SG	hozomány
angolokkal	pos=N,case=DAT,num=SG	angolnak
eszményeid	pos=N,case=INS,num=SG	eszménnyel
ágytálakból	pos=N,case=ABL,num=SG	ágytáltól
sógornőnek	pos=N,case=DAT,num=PL	sógornőknek
ajándékban	pos=N,case=ON+ALL,num=PL	ajándékokra
halmazig	pos=N,case=INS,num=SG	halmazzal
varrónőnk	pos=N,case=ABL,num=PL	varrónőktől
osztálytól	pos=N,case=IN+ESS,num=SG	osztályban
ürügyeitek	pos=N,case=NOM,num=PL	ürügyek
végekhez	pos=N,case=FRML,num=PL	végekként
bizonyítékról	pos=N,case=PRP,num=PL	bizonyítékokért
ösztöndíjaitok	pos=N,case=IN+ABL,num=PL	ösztöndíjakból
remekbe	pos=N,case=ON+ALL,num=PL	remekekre
úrnőkig	pos=N,case=PRP,num=PL	úrnőkért
varrónőkért	pos=N,case=ON+ALL,num=PL	varrónőkre
mentségeitek	pos=N,case=TRANS,num=PL	mentségekké
döntésekbe	pos=N,case=DAT,num=PL	döntéseknek
bázisokhoz	pos=N,case=ABL,num=SG	bázistól
fakíroknál	pos=N,case=ON+ESS,num=SG	fakíron
útpadkákban	pos=N,case=AT+ESS,num=PL	útpadkáknál
lengyelem	pos=N,case=BYWAY,num=SG	lengyelül
rendelkezéshez	pos=N,case=NOM,num=PL	rendelkezések
ürügyekként	pos=N,case=INS,num=PL	ürügyekkel
eszményekként	pos=N,case=NOM,num=SG	eszmény
ösztöndíjakra	pos=N,case=IN+ALL,num=SG	ösztöndíjba
alapod	pos=N,case=PRP,num=SG	alapért
őrhöz	pos=N,case=ON+ALL,num=PL	őrökre
khmerrel	pos=N,case=IN+ABL,num=PL	khmerekből
árindexnek	pos=N,case=ABL,num=SG	árindextől
sógornőm	pos=N,case=ABL,num=PL	sógornőktől
válaszoknál	pos=N,case=TRANS,num=PL	válaszokká
akadályokról	pos=N,case=ACC,num=SG	akadályt
ágytálnak	pos=N,case=NOM,num=SG	ágytál
természeteket	pos=N,case=BYWAY,num=SG	természetül
németnél	pos=N,case=TERM,num=SG	németig
eszményeknél	pos=N,case=TERM,num=SG	eszményig
flamandjaink	pos=N,case=INS,num=SG	flamanddal
sebtapasszal	pos=N,case=NOM,num=SG	sebtapasz
angolom	pos=N,case=ABL,num=SG	angoltól
nyenyecekbe	pos=N,case=IN+ESS,num=PL	nyenyecekben
rendőrnőkbe	pos=N,case=ON+ALL,num=SG	rendőrnőre
nagydíjaim	pos=N,case=TERM,num=SG	nagydíjig
ágytálakkal	pos=N,case=IN+ABL,num=SG	ágytálból
célpontokra	pos=N,case=BYWAY,num=PL	célpontokul
sebtapaszokról	pos=N,case=IN+ALL,num=SG	sebtapaszba
törzseitek	pos=N,case=ACC,num=PL	törzseket
ajándékokra	pos=N,case=NOM,num=PL	ajándékok
remekeken	pos=N,case=AT+ESS,num=PL	remekeknél
eszményetek	pos=N,case=ON+ABL,num=PL	eszményekről
angolokkal	pos=N,case=DAT,num=PL	angoloknak
díjként	pos=N,case=FRML,num=PL	díjakként
adományaink	pos=N,case=ACC,num=PL	adományokat
tulajdonosnőül	pos=N,case=DAT,num=PL	tulajdonosnőknek
mentségekért	pos=N,case=INS,num=SG	mentséggel
válaszról	pos=N,case=ON+ESS,num=SG	válaszon
magyarokon	pos=N,case=IN+ESS,num=SG	magyarban
adatokról	pos=N,case=FRML,num=SG	adatként
bosnyákjaim	pos=N,case=ABL,num=PL	bosnyákoktól
sógornőkké	pos=N,case=ALL,num=SG	sógornőhöz
ösztöndíjakra	pos=N,case=DAT,num=SG	ösztöndíjnak
ösztöndíjunk	pos=N,case=ABL,num=SG	ösztöndíjtól
elismerésekről	pos=N,case=NOM,num=PL	elismerések
ürügyekben	pos=N,case=PRP,num=PL	ürügyekért
lengyelen	pos=N,case=ALL,num=PL	lengyelekhez
akadályt	pos=N,case=DAT,num=SG	akadálynak
apácafőnöknőként	pos=N,case=FRML,num=PL	apácafőnöknőkként
tanítványaink	pos=N,case=TRANS,num=PL	tanítványokká
ógörögjeim	pos=N,case=NOM,num=SG	ógörög
kutyákkal	pos=N,case=ON+ABL,num=SG	kutyáról
célpontokban	pos=N,case=TERM,num=PL	célpontokig
természetekre	pos=N,case=ON+ESS,num=SG	természeten
példaképeitek	pos=N,case=IN+ESS,num=PL	példaképekben
tudomásaik	pos=N,case=ON+ABL,num=SG	tudomásról
németek	pos=N,case=ACC,num=SG	németet
példaképekben	pos=N,case=TRANS,num=SG	példaképpé
németeknél	pos=N,case=ON+ALL,num=SG	németre
úrnőkről	pos=N,case=ACC,num=PL	úrnőket
ágytálul	pos=N,case=NOM,num=PL	ágytálak
útpadkáért	pos=N,case=FRML,num=PL	útpadkákként
őrre	pos=N,case=FRML,num=SG	őrként
baskírokkal	pos=N,case=ALL,num=SG	baskírhoz
árindexbe	pos=N,case=INS,num=SG	árindexszel
ógörögökig	pos=N,case=PRP,num=PL	ógörögökért
nyenyeceknek	pos=N,case=PRP,num=SG	nyenyecért
bázisotok	pos=N,case=BYWAY,num=PL	bázisokul
hozományt	pos=N,case=DAT,num=PL	hozományoknak
őrünk	pos=N,case=BYWAY,num=PL	őrökül
tudomásért	pos=N,case=INS,num=PL	tudomásokkal
sógornőkkel	pos=N,case=ABL,num=PL	sógornőktől
árindexe	pos=N,case=BYWAY,num=SG	árindexül
bizonyítékaim	pos=N,case=BYWAY,num=PL	bizonyítékokul
alosztályaitok	pos=N,case=IN+ABL,num=SG	alosztályból
végekért	pos=N,case=BYWAY,num=SG	végül
fakírunk	pos=N,case=BYWAY,num=SG	fakírul
osztályunk	pos=N,case=DAT,num=PL	osztályoknak
példaképeid	pos=N,case=PRP,num=PL	példaképekért
khmerektől	pos=N,case=INS,num=SG	khmerrel
magyaroknál	pos=N,case=DAT,num=PL	magyaroknak
díjunk	pos=N,case=PRP,num=PL	díjakért
döntésen	pos=N,case=FRML,num=PL	döntésekként
mentséghez	pos=N,case=IN+ESS,num=SG	mentségben
mentségek	pos=N,case=IN+ALL,num=SG	mentségbe
bázisokból	pos=N,case=FRML,num=PL	bázisokként
remekekről	pos=N,case=INS,num=SG	remekkel
khmerben	pos=N,case=ON+ALL,num=PL	khmerekre
döntésen	pos=N,case=AT+ESS,num=SG	döntésnél
ógörögnek	pos=N,case=DAT,num=PL	ógörögöknek
döntések	pos=N,case=INS,num=PL	döntésekkel
ösztöndíjakról	pos=N,case=ON+ESS,num=PL	ösztöndíjakon
megállapodásokat	pos=N,case=PRP,num=PL	megállapodásokért
sógornővé	pos=N,case=FRML,num=SG	sógornőként
rendelkezéseket	pos=N,case=IN+ESS,num=SG	rendelkezésben
magyarokig	pos=N,case=IN+ESS,num=PL	magyarokban
ágytálakban	pos=N,case=AT+ESS,num=PL	ágytálaknál
akadályai	pos=N,case=TRANS,num=SG	akadállyá
könyvtárosnőről	pos=N,case=ON+ESS,num=SG	könyvtárosnőn
tulajdonosnő	pos=N,case=TRANS,num=PL	tulajdonosnőkké
célpontnál	pos=N,case=ACC,num=PL	célpontokat
feleségbe	pos=N,case=NOM,num=SG	feleség
lengyelekért	pos=N,case=TRANS,num=SG	lengyellé
ajándékká	pos=N,case=IN+ESS,num=SG	ajándékban
rendelkezésből	pos=N,case=ABL,num=SG	rendelkezéstől
baskírról	pos=N,case=ON+ESS,num=SG	baskíron
vánkosra	pos=N,case=IN+ESS,num=PL	vánkosokban
útpadkákból	pos=N,case=ON+ALL,num=PL	útpadkákra
ógörögnél	pos=N,case=ABL,num=PL	ógörögöktől
portugálba	pos=N,case=NOM,num=SG	portugál
döntései	pos=N,case=ACC,num=SG	döntést
természetekre	pos=N,case=INS,num=PL	természetekkel
útpadkákat	pos=N,case=IN+ABL,num=SG	útpadkából
remekeink	pos=N,case=TERM,num=SG	remekig
úrnőink	pos=N,case=FRML,num=SG	úrnőként
adományokig	pos=N,case=NOM,num=PL	adományok
úrnőnk	pos=N,case=AT+ESS,num=PL	úrnőknél
alosztályaink	pos=N,case=ON+ESS,num=PL	alosztályokon
bázisokért	pos=N,case=BYWAY,num=SG	bázisul
törzsünk	pos=N,case=AT+ESS,num=SG	törzsnél
remekeken	pos=N,case=ON+ALL,num=SG	remekre
rendőrnője	pos=N,case=ON+ESS,num=SG	rendőrnőn
végekbe	pos=N,case=TERM,num=PL	végekig
hollandjaid	pos=N,case=ON+ABL,num=SG	hollandról
rendelkezései	pos=N,case=FRML,num=SG	rendelkezésként
adatokat	pos=N,case=TERM,num=PL	adatokig
németről	pos=N,case=IN+ABL,num=PL	németekből
nevelőnőink	pos=N,case=NOM,num=SG	nevelőnő
varrónővel	pos=N,case=NOM,num=PL	varrónők
bázistól	pos=N,case=AT+ESS,num=SG	bázisnál
bővítései	pos=N,case=DAT,num=PL	bővítéseknek
japánban	pos=N,case=PRP,num=SG	japánért
ajándékokig	pos=N,case=BYWAY,num=SG	ajándékul
varrónővel	pos=N,case=FRML,num=PL	varrónőkként
nevelőnője	pos=N,case=NOM,num=PL	nevelőnők
varrónőül	pos=N,case=IN+ABL,num=PL	varrónőkből
portugálban	pos=N,case=IN+ABL,num=PL	portugálokból
ágytálaim	pos=N,case=ON+ALL,num=PL	ágytálakra
nagydíjakká	pos=N,case=ON+ALL,num=PL	nagydíjakra
japánoknak	pos=N,case=IN+ALL,num=PL	japánokba
célpontot	pos=N,case=IN+ALL,num=SG	célpontba
