abartırım	pos=V,polar=POS,mood=IND,inter=DECL,tense=PRS,per=2,num=SG,aspect={IPFV/PFV}	abartırsın
abartırsın	pos=V,polar=POS,mood=IND,inter=DECL,tense=PST,per=3,num=SG,aspect=PFV	abarttı
acıkıyorduk	pos=V,polar=NEG,mood=IND,inter=DECL,tense=PST,per=2,num=PL,aspect=PFV	acıkmadınız
acıkmıyordular	pos=V,polar=POS,mood=IND,inter=DECL,tense=PRS,per=3,num=PL,aspect=PROG	acıkıyorlar
acıktırtırız	pos=V,polar=NEG,mood=IND,inter=DECL,tense=PST,per=2,num=PL,aspect=PFV	acıktırtmadınız
acıktırtıyordu	pos=V,polar=NEG,mood=IND,inter=DECL,tense=PRS,per=2,num=SG,aspect=PROG	acıktırtmıyorsun
acıktırtıyorsunuz	pos=V,polar=POS,mood=IND,inter=DECL,tense=PRS,per=3,num=SG,aspect={IPFV/PFV}	acıktırtır
acıktırtmaz	pos=V,polar=POS,mood=IND,inter=DECL,tense=PRS,per=2,num=SG,aspect={IPFV/PFV}	acıktırtırsın
acıktırttı	pos=V,polar=NEG,mood=IND,inter=DECL,tense=PRS,per=2,num=PL,aspect=PROG	acıktırtmıyorsunuz
acıktırttı	pos=V,polar=NEG,mood=IND,inter=DECL,tense=PST,per=1,num=SG,aspect=PFV	acıktırtmadım
açıldılar	pos=V,polar=POS,mood=IND,inter=DECL,tense=PRS,per=2,num=PL,aspect={IPFV/PFV}	açılırsınız
açıldı	pos=V,polar=NEG,mood=IND,inter=DECL,tense=PRS,per=1,num=SG,aspect=PROG	açılmıyorum
açılmayız	pos=V,polar=NEG,mood=IND,inter=DECL,tense=PRS,per=2,num=PL,aspect={IPFV/PFV}	açılmazsınız
acımadınız	pos=V,polar=POS,mood=IND,inter=DECL,tense=PRS,per=3,num=PL,aspect={IPFV/PFV}	acırlar
acısını	pos=N,tense=PRS,per=1,num=PL,aspect={IPFV/PFV}	acılarız
acıtıyordun	pos=V,polar=NEG,mood=IND,inter=DECL,tense=PRS,per=1,num=SG,aspect=PROG	acıtmıyorum
acıtıyorum	pos=V,polar=NEG,mood=IND,inter=DECL,tense=PST,per=1,num=PL,aspect=PFV	acıtmadık
acıtıyorum	pos=V,polar=POS,mood=IND,inter=DECL,tense=PRS,per=3,num=SG,aspect={IPFV/PFV}	acıtır
acıtmadı	pos=V,polar=POS,mood=IND,inter=DECL,tense=PRS,per=2,num=SG,aspect=PROG	acıtıyorsun
acıttın	pos=V,polar=POS,mood=IND,inter=DECL,tense=PST,per=2,num=SG,aspect={IPFV/PROG}	acıtıyordun
acıyacaksın	pos=V,polar=POS,mood=IND,inter=DECL,tense=PST,per=1,num=PL,aspect=PFV	acıdık
acıyor	pos=V,polar=POS,mood=IND,inter=DECL,tense=PRS,per=2,num=SG,aspect=PROG	acıyorsun
açıyorsunuz	pos=V,polar=NEG,mood=IND,inter=DECL,tense=PRS,per=1,num=SG,aspect=PROG	açmıyorum
acıyorsunuz	pos=V,polar=POS,mood=IND,inter=DECL,tense=PRS,per=3,num=PL,aspect={IPFV/PFV}	acırlar
açmayacağız	pos=V,polar=POS,mood=IND,inter=DECL,tense=PRS,per=1,num=SG,aspect={IPFV/PFV}	açarım
açmaz	pos=V,polar=POS,mood=IND,inter=DECL,tense=PRS,per=1,num=PL,aspect=PROG	açıyoruz
açmıyorum	pos=V,polar=POS,mood=IND,inter=DECL,tense=PRS,per=3,num=PL,aspect={IPFV/PFV}	açarlar
açtılar	pos=V,polar=POS,mood=IND,inter=DECL,tense=PRS,per=2,num=SG,aspect=PROG	açıyorsun
adıyordu	pos=V,tense=PST,per=3,num=PL,aspect={IPFV/PROG}	adıyorlardı
ağam	pos=N,tense=PRS,per=2,num=PL,aspect={IPFV/PFV}	ağalarsınız
ağasını	pos=N,tense=PRS,per=1,num=SG,aspect={IPFV/PFV}	ağayız
ağdacımızdan	pos=N,tense=PRS,per=2,num=SG,aspect={IPFV/PFV}	ağdacısınız
ağlamadın	pos=V,polar=POS,mood=IND,inter=DECL,tense=PST,per=2,num=SG,aspect={IPFV/PROG}	ağlıyordun
ağlamaz	pos=V,polar=POS,mood=IND,inter=DECL,tense=PST,per=1,num=SG,aspect=PFV	ağladım
ağlamıyorlar	pos=V,polar=NEG,mood=IND,inter=DECL,tense=PST,per=2,num=SG,aspect=PFV	ağlamadın
ağlaşadı	pos=V,polar=NEG,mood=IND,inter=DECL,tense=PRS,per=2,num=PL,aspect={IPFV/PFV}	ağlaşamazsınız
ağlaşamadınız	pos=V,polar=POS,mood=IND,inter=DECL,tense=PST,per=2,num=PL,aspect={IPFV/PROG}	ağlaşıyordunuz
ağlaşamıyor	pos=V,polar=NEG,mood=IND,inter=DECL,tense=PRS,per=3,num=SG,aspect={IPFV/PFV}	ağlaşamaz
ağlaşıyordunuz	pos=V,polar=NEG,mood=IND,inter=DECL,tense=PST,per=2,num=PL,aspect={IPFV/PROG}	ağlaşamıyordunuz
ağlaşıyordu	pos=V,polar=NEG,mood=IND,inter=DECL,tense=PST,per=1,num=SG,aspect=PFV	ağlaşamadım
ağlatacağız	pos=V,tense=PRS,per=1,num=SG,aspect={IPFV/PFV}	ağlatırım
ağlatıyorlar	pos=V,tense=PRS,per=2,num=PL,aspect=PROG	ağlatıyorsunuz
ağlatıyorsunuz	pos=V,tense=PRS,per=1,num=PL,aspect={IPFV/PFV}	ağlatırız
ağlattırırım	pos=V,tense=PST,per=3,num=SG,aspect={IPFV/PROG}	ağlattırıyordu
ağlattırtı	pos=V,tense=PST,per=2,num=PL,aspect={IPFV/PROG}	ağlattırıyordunuz
ağlıyordun	pos=V,polar=POS,mood=IND,inter=DECL,tense=PRS,per=2,num=SG,aspect={IPFV/PFV}	ağlarsın
akreplerimizde	pos=N,tense=PRS,per=3,num=SG,aspect={IPFV/PFV}	akrepler
aktrisimizden	pos=N,tense=PRS,per=1,num=PL,aspect={IPFV/PFV}	aktrisleriz
aldatıyoruz	pos=V,polar=POS,mood=IND,inter=DECL,tense=PST,per=2,num=SG,aspect=PFV	aldattın
aldatmayacağım	pos=V,polar=POS,mood=IND,inter=DECL,tense=PRS,per=2,num=PL,aspect=PROG	aldatıyorsunuz
aldatmıyordum	pos=V,polar=POS,mood=IND,inter=DECL,tense=PRS,per=1,num=SG,aspect={IPFV/PFV}	aldatırım
aldatmıyor	pos=V,polar=NEG,mood=IND,inter=DECL,tense=PRS,per=2,num=PL,aspect=PROG	aldatmıyorsunuz
aldattılar	pos=V,polar=POS,mood=IND,inter=DECL,tense=PST,per=1,num=SG,aspect=PFV	aldattım
aldırdık	pos=V,polar=NEG,mood=IND,inter=DECL,tense=PST,per=3,num=SG,aspect={IPFV/PROG}	aldırmıyordu
aldırmıyorduk	pos=V,polar=NEG,mood=IND,inter=DECL,tense=PST,per=1,num=SG,aspect={IPFV/PROG}	aldırmıyordum
aldırmıyordunuz	pos=V,polar=POS,mood=IND,inter=DECL,tense=PRS,per=3,num=SG,aspect=PROG	aldırıyor
aldırtırma	pos=V,polar=NEG,mood=IND,inter=DECL,tense=PST,per=2,num=PL,aspect={IPFV/PROG}	aldırtmamıyordunuz
aldırtırma	pos=V,polar=POS,mood=IND,inter=DECL,tense=PST,per=1,num=SG,aspect={IPFV/PROG}	aldırtmaıyordum
aldırtıyordunuz	pos=V,polar=POS,mood=IND,inter=DECL,tense=PRS,per=2,num=SG,aspect=PROG	aldırtıyorsun
aldırtmaacaksın	pos=V,polar=POS,mood=IND,inter=DECL,tense=PRS,per=2,num=PL,aspect=PROG	aldırtmaıyorsunuz
aldırtmadın	pos=V,polar=POS,mood=IND,inter=DECL,tense=PST,per=3,num=SG,aspect=PFV	aldırttı
aldırtmamıyordular	pos=V,polar=POS,mood=IND,inter=DECL,tense=PST,per=3,num=PL,aspect=PFV	aldırtmatılar
aldırtmamıyordunuz	pos=V,polar=NEG,mood=IND,inter=DECL,tense=PST,per=3,num=PL,aspect={IPFV/PROG}	aldırtmamıyordular
aldırtmayacağız	pos=V,polar=NEG,mood=IND,inter=DECL,tense=PST,per=1,num=SG,aspect=PFV	aldırtmadım
âliminizde	pos=N,tense=PRS,per=3,num=PL,aspect={IPFV/PFV}	âlimlerdir
âliminizin	pos=N,tense=PRS,per=2,num=SG,aspect={IPFV/PFV}	âlimsiniz
alındırmam	pos=V,polar=NEG,mood=IND,inter=DECL,tense=PRS,per=1,num=PL,aspect={IPFV/PFV}	alındırmayız
alındırmıyorum	pos=V,polar=POS,mood=IND,inter=DECL,tense=PST,per=3,num=SG,aspect={IPFV/PROG}	alındırıyordu
alındırtacaksın	pos=V,polar=NEG,mood=IND,inter=DECL,tense=PRS,per=2,num=PL,aspect={IPFV/PFV}	alındırtmazsınız
alındırtmadı	pos=V,polar=NEG,mood=IND,inter=DECL,tense=PRS,per=1,num=PL,aspect={IPFV/PFV}	alındırtmayız
alındırtmam	pos=V,polar=NEG,mood=IND,inter=DECL,tense=PRS,per=1,num=PL,aspect={IPFV/PFV}	alındırtmayız
alındırtmayacaklar	pos=V,polar=NEG,mood=IND,inter=DECL,tense=PST,per=3,num=PL,aspect=PFV	alındırtmadılar
alındırttılar	pos=V,polar=NEG,mood=IND,inter=DECL,tense=PRS,per=3,num=SG,aspect=PROG	alındırtmıyor
alındırttınız	pos=V,polar=POS,mood=IND,inter=DECL,tense=PST,per=1,num=PL,aspect=PFV	alındırttık
alışacak	pos=V,polar=NEG,mood=IND,inter=DECL,tense=PRS,per=2,num=SG,aspect={IPFV/PFV}	alışmazsın
alışacaksın	pos=V,polar=NEG,mood=IND,inter=DECL,tense=PRS,per=3,num=PL,aspect=PROG	alışmıyorlar
alışacaksın	pos=V,polar=POS,mood=IND,inter=DECL,tense=PST,per=3,num=PL,aspect={IPFV/PROG}	alışıyorlardı
alışıyorlardı	pos=V,polar=POS,mood=IND,inter=DECL,tense=PST,per=3,num=SG,aspect=PFV	alıştı
alışıyorlar	pos=V,polar=POS,mood=IND,inter=DECL,tense=PST,per=1,num=SG,aspect={IPFV/PROG}	alışıyordum
alışmayız	pos=V,polar=NEG,mood=IND,inter=DECL,tense=PST,per=3,num=PL,aspect=PFV	alışmadılar
almıyorlar	pos=V,polar=POS,mood=IND,inter=DECL,tense=PRS,per=1,num=SG,aspect={IPFV/PFV}	alırım
almıyorsunuz	pos=V,polar=NEG,mood=IND,inter=DECL,tense=PST,per=1,num=SG,aspect={IPFV/PROG}	almıyordum
anarlar	pos=V,polar=NEG,mood=IND,inter=DECL,tense=PRS,per=1,num=PL,aspect=PROG	anmıyoruz
andı	pos=V,polar=NEG,mood=IND,inter=DECL,tense=PST,per=3,num=SG,aspect={IPFV/PROG}	anmıyordu
angutlarımda	pos=N,tense=PRS,per=1,num=PL,aspect={IPFV/PFV}	angutlarız
anıyorsunuz	pos=V,polar=POS,mood=IND,inter=DECL,tense=PRS,per=1,num=PL,aspect=PROG	anıyoruz
anlatırım	pos=V,polar=NEG,mood=IND,inter=DECL,tense=PRS,per=2,num=SG,aspect={IPFV/PFV}	anlatmazsın
anlatırız	pos=V,polar=NEG,mood=IND,inter=DECL,tense=PST,per=1,num=SG,aspect={IPFV/PROG}	anlatmıyordum
anlatıyordun	pos=V,polar=POS,mood=IND,inter=DECL,tense=PRS,per=3,num=PL,aspect={IPFV/PFV}	anlatırlar
anlattım	pos=V,polar=POS,mood=IND,inter=DECL,tense=PRS,per=3,num=SG,aspect={IPFV/PFV}	anlatır
anmayacak	pos=V,polar=POS,mood=IND,inter=DECL,tense=PRS,per=1,num=SG,aspect={IPFV/PFV}	anarım
aradınız	pos=V,polar=NEG,mood=IND,inter=DECL,tense=PRS,per=3,num=PL,aspect={IPFV/PFV}	aramazlar
aramayacaklar	pos=V,polar=NEG,mood=IND,inter=DECL,tense=PST,per=3,num=PL,aspect=PFV	aramadılar
aramıyordun	pos=V,polar=NEG,mood=IND,inter=DECL,tense=PST,per=2,num=PL,aspect={IPFV/PROG}	aramıyordunuz
arıyordu	pos=V,polar=NEG,mood=IND,inter=DECL,tense=PRS,per=1,num=PL,aspect=PROG	aramıyoruz
arıyoruz	pos=V,polar=NEG,mood=IND,inter=DECL,tense=PRS,per=1,num=PL,aspect=PROG	aramıyoruz
arkadaşlardır	pos=N,tense=PRS,per=3,num=SG,aspect={IPFV/PFV}	arkadaşlar
arzuhalcileri	pos=N,tense=PRS,per=3,num=SG,aspect={IPFV/PFV}	arzuhalciler
arzuhalcileriz	pos=N,tense=PRS,per=2,num=SG,aspect={IPFV/PFV}	arzuhalcisiniz
aşarım	pos=V,polar=NEG,mood=IND,inter=DECL,tense=PST,per=3,num=SG,aspect={IPFV/PROG}	aşmıyordu
aseksüele	pos=N,tense=PRS,per=3,num=SG,aspect={IPFV/PFV}	aseksüeller
aşıklardık	pos=N,tense=PRS,per=3,num=PL,aspect={IPFV/PFV}	aşıklardır
aşıyorlardı	pos=V,polar=POS,mood=IND,inter=DECL,tense=PRS,per=2,num=SG,aspect={IPFV/PFV}	aşarsın
asıyorlardı	pos=V,polar=POS,mood=IND,inter=DECL,tense=PST,per=1,num=PL,aspect=PFV	astık
asıyor	pos=V,polar=POS,mood=IND,inter=DECL,tense=PST,per=3,num=PL,aspect=PFV	astılar
aşıyorsun	pos=V,polar=NEG,mood=IND,inter=DECL,tense=PRS,per=2,num=SG,aspect=PROG	aşmıyorsun
asıyorsunuz	pos=V,polar=NEG,mood=IND,inter=DECL,tense=PRS,per=1,num=PL,aspect={IPFV/PFV}	asmayız
aşmadınız	pos=V,polar=NEG,mood=IND,inter=DECL,tense=PRS,per=1,num=PL,aspect={IPFV/PFV}	aşmayız
aşmayacağız	pos=V,polar=NEG,mood=IND,inter=DECL,tense=PRS,per=1,num=PL,aspect=PROG	aşmıyoruz
asmayacaklar	pos=V,polar=NEG,mood=IND,inter=DECL,tense=PST,per=2,num=PL,aspect=PFV	asmadınız
aşmazlar	pos=V,polar=POS,mood=IND,inter=DECL,tense=PST,per=1,num=PL,aspect={IPFV/PROG}	aşıyorduk
asmıyorsun	pos=V,polar=POS,mood=IND,inter=DECL,tense=PRS,per=2,num=PL,aspect={IPFV/PFV}	asarsınız
aşmıyoruz	pos=V,polar=NEG,mood=IND,inter=DECL,tense=PRS,per=2,num=SG,aspect=PROG	aşmıyorsun
aştılar	pos=V,polar=POS,mood=IND,inter=DECL,tense=PRS,per=1,num=PL,aspect={IPFV/PFV}	aşarız
astım	pos=V,polar=POS,mood=IND,inter=DECL,tense=PRS,per=2,num=SG,aspect=PROG	asıyorsun
atılıyorlardı	pos=V,polar=NEG,mood=IND,inter=DECL,tense=PRS,per=2,num=PL,aspect=PROG	atılmıyorsunuz
atılmadın	pos=V,polar=NEG,mood=IND,inter=DECL,tense=PST,per=1,num=PL,aspect={IPFV/PROG}	atılmıyorduk
atılmayacağız	pos=V,polar=POS,mood=IND,inter=DECL,tense=PRS,per=3,num=SG,aspect={IPFV/PFV}	atılır
atılmazsın	pos=V,polar=POS,mood=IND,inter=DECL,tense=PRS,per=3,num=PL,aspect=PROG	atılıyorlar
atılmıyorum	pos=V,polar=POS,mood=IND,inter=DECL,tense=PRS,per=1,num=PL,aspect=PROG	atılıyoruz
atışıyorsunuz	pos=V,polar=NEG,mood=IND,inter=DECL,tense=PST,per=2,num=PL,aspect={IPFV/PROG}	atışmıyordunuz
atışıyorsunuz	pos=V,polar=POS,mood=IND,inter=DECL,tense=PRS,per=1,num=SG,aspect=PROG	atışıyorum
atışmadınız	pos=V,polar=POS,mood=IND,inter=DECL,tense=PST,per=2,num=PL,aspect=PFV	atıştınız
atışmayacak	pos=V,polar=POS,mood=IND,inter=DECL,tense=PST,per=1,num=SG,aspect=PFV	atıştım
atışmazsın	pos=V,polar=POS,mood=IND,inter=DECL,tense=PRS,per=2,num=PL,aspect={IPFV/PFV}	atışırsınız
atıştırıyordum	pos=V,polar=POS,mood=IND,inter=DECL,tense=PST,per=1,num=SG,aspect=PFV	atıştırtım
atıştırmayacaksın	pos=V,polar=NEG,mood=IND,inter=DECL,tense=PRS,per=1,num=PL,aspect={IPFV/PFV}	atıştırmayız
atıştırmıyorum	pos=V,polar=NEG,mood=IND,inter=DECL,tense=PST,per=1,num=PL,aspect={IPFV/PROG}	atıştırmıyorduk
atıştırtılar	pos=V,polar=NEG,mood=IND,inter=DECL,tense=PRS,per=3,num=PL,aspect=PROG	atıştırmıyorlar
atıştırtılar	pos=V,polar=POS,mood=IND,inter=DECL,tense=PRS,per=3,num=SG,aspect=PROG	atıştırıyor
atıyorduk	pos=V,polar=POS,mood=IND,inter=DECL,tense=PST,per=2,num=SG,aspect=PFV	attın
atıyorsun	pos=V,polar=POS,mood=IND,inter=DECL,tense=PRS,per=2,num=PL,aspect=PROG	atıyorsunuz
atmadınız	pos=V,polar=NEG,mood=IND,inter=DECL,tense=PST,per=3,num=SG,aspect=PFV	atmadı
atmamayacaksınız	pos=V,polar=POS,mood=IND,inter=DECL,tense=PST,per=2,num=SG,aspect=PFV	atmatın
atmamazlar	pos=V,polar=NEG,mood=IND,inter=DECL,tense=PST,per=3,num=PL,aspect=PFV	atmamadılar
atmatı	pos=V,polar=NEG,mood=IND,inter=DECL,tense=PRS,per=3,num=SG,aspect={IPFV/PFV}	atmamaz
atmatı	pos=V,polar=POS,mood=IND,inter=DECL,tense=PRS,per=3,num=PL,aspect={IPFV/PFV}	atmazlar
attırıyor	pos=V,polar=POS,mood=IND,inter=DECL,tense=PRS,per=3,num=PL,aspect=PROG	attırıyorlar
attırmadılar	pos=V,polar=POS,mood=IND,inter=DECL,tense=PST,per=1,num=SG,aspect=PFV	attırdım
attırmam	pos=V,polar=NEG,mood=IND,inter=DECL,tense=PRS,per=2,num=PL,aspect={IPFV/PFV}	attırmazsınız
attırmıyorsunuz	pos=V,polar=NEG,mood=IND,inter=DECL,tense=PRS,per=3,num=SG,aspect={IPFV/PFV}	attırmaz
ayarlanacak	pos=V,polar=POS,mood=IND,inter=DECL,tense=PRS,per=2,num=SG,aspect={IPFV/PFV}	ayarlanırsın
ayarlandınız	pos=V,polar=POS,mood=IND,inter=DECL,tense=PST,per=3,num=PL,aspect=PFV	ayarlandılar
ayarlanırım	pos=V,polar=NEG,mood=IND,inter=DECL,tense=PST,per=1,num=PL,aspect={IPFV/PROG}	ayarlanmıyorduk
ayarlanıyorsun	pos=V,polar=NEG,mood=IND,inter=DECL,tense=PST,per=3,num=SG,aspect=PFV	ayarlanmadı
ayarlanmam	pos=V,polar=POS,mood=IND,inter=DECL,tense=PST,per=1,num=SG,aspect={IPFV/PROG}	ayarlanıyordum
ayarlanmayacaksınız	pos=V,polar=NEG,mood=IND,inter=DECL,tense=PRS,per=3,num=PL,aspect={IPFV/PFV}	ayarlanmazlar
ayarlanmazsınız	pos=V,polar=POS,mood=IND,inter=DECL,tense=PRS,per=3,num=SG,aspect=PROG	ayarlanıyor
ayarlanmıyordular	pos=V,polar=POS,mood=IND,inter=DECL,tense=PST,per=2,num=PL,aspect={IPFV/PROG}	ayarlanıyordunuz
ayarlanmıyordun	pos=V,polar=POS,mood=IND,inter=DECL,tense=PST,per=2,num=PL,aspect={IPFV/PROG}	ayarlanıyordunuz
ayarlanmıyorum	pos=V,polar=POS,mood=IND,inter=DECL,tense=PST,per=3,num=PL,aspect={IPFV/PROG}	ayarlanıyorlardı
ayarlatacağım	pos=V,polar=POS,mood=IND,inter=DECL,tense=PRS,per=1,num=SG,aspect=PROG	ayarlatıyorum
ayarlattırıyorsun	pos=V,polar=NEG,mood=IND,inter=DECL,tense=PST,per=2,num=SG,aspect={IPFV/PROG}	ayarlattırmıyordun
ayarlattırmıyor	pos=V,polar=NEG,mood=IND,inter=DECL,tense=PST,per=3,num=SG,aspect={IPFV/PROG}	ayarlattırmıyordu
ayarlattırtın	pos=V,polar=POS,mood=IND,inter=DECL,tense=PST,per=1,num=PL,aspect=PFV	ayarlattırtık
ayılarda	pos=N,tense=PRS,per=2,num=SG,aspect={IPFV/PFV}	ayısınız
ayrılacağım	pos=V,polar=NEG,mood=IND,inter=DECL,tense=PST,per=1,num=SG,aspect={IPFV/PROG}	ayrılmıyordum
ayrılırız	pos=V,polar=POS,mood=IND,inter=DECL,tense=PRS,per=3,num=SG,aspect=PROG	ayrılıyor
ayrılıyorlardı	pos=V,polar=NEG,mood=IND,inter=DECL,tense=PRS,per=2,num=PL,aspect={IPFV/PFV}	ayrılmazsınız
azıyordum	pos=V,polar=POS,mood=IND,inter=DECL,tense=PRS,per=2,num=PL,aspect={IPFV/PFV}	azırsınız
azmadık	pos=V,polar=POS,mood=IND,inter=DECL,tense=PST,per=3,num=PL,aspect={IPFV/PROG}	azıyorlardı
azmıyorsunuz	pos=V,polar=NEG,mood=IND,inter=DECL,tense=PRS,per=1,num=PL,aspect=PROG	azmıyoruz
babalılardır	pos=N,tense=PRS,per=3,num=SG,aspect={IPFV/PFV}	babalılar
bacımız	pos=N,tense=PRS,per=1,num=PL,aspect={IPFV/PFV}	bacılarız
bağışlayacağım	pos=V,tense=PRS,per=2,num=SG,aspect=PROG	bağışlıyorsun
bağışlayacağım	pos=V,tense=PRS,per=3,num=PL,aspect=PROG	bağışlıyorlar
bağışlıyordu	pos=V,tense=PRS,per=1,num=PL,aspect=PROG	bağışlıyoruz
bağışlıyorlar	pos=V,tense=PRS,per=1,num=SG,aspect={IPFV/PFV}	bağışlarım
bağışlıyoruz	pos=V,tense=PRS,per=1,num=SG,aspect=PROG	bağışlıyorum
bağlamadılar	pos=V,polar=NEG,mood=IND,inter=DECL,tense=PRS,per=3,num=PL,aspect=PROG	bağlamıyorlar
bağlamayacaklar	pos=V,polar=NEG,mood=IND,inter=DECL,tense=PRS,per=2,num=SG,aspect={IPFV/PFV}	bağlamazsın
bağlamıyordum	pos=V,polar=POS,mood=IND,inter=DECL,tense=PST,per=2,num=PL,aspect={IPFV/PROG}	bağlıyordunuz
bağlıyordun	pos=V,polar=NEG,mood=IND,inter=DECL,tense=PRS,per=1,num=PL,aspect=PROG	bağlamıyoruz
bağlıyordu	pos=V,polar=NEG,mood=IND,inter=DECL,tense=PST,per=1,num=SG,aspect={IPFV/PROG}	bağlamıyordum
bakanlarımızda	pos=N,tense=PRS,per=3,num=SG,aspect={IPFV/PFV}	bakanlar
bakarım	pos=V,polar=POS,mood=IND,inter=DECL,tense=PST,per=1,num=PL,aspect=PFV	baktık
bakirelerinizin	pos=N,tense=PRS,per=1,num=PL,aspect={IPFV/PFV}	bakireleriz
bakiremiz	pos=N,tense=PRS,per=1,num=PL,aspect={IPFV/PFV}	bakireleriz
bakirine	pos=N,tense=PRS,per=2,num=PL,aspect={IPFV/PFV}	bakirlersiniz
bakıyordun	pos=V,polar=NEG,mood=IND,inter=DECL,tense=PST,per=2,num=PL,aspect={IPFV/PROG}	bakmıyordunuz
bakıyorsunuz	pos=V,polar=NEG,mood=IND,inter=DECL,tense=PST,per=1,num=PL,aspect={IPFV/PROG}	bakmıyorduk
bakmam	pos=V,polar=POS,mood=IND,inter=DECL,tense=PRS,per=3,num=SG,aspect=PROG	bakıyor
bakmayacak	pos=V,polar=NEG,mood=IND,inter=DECL,tense=PST,per=3,num=PL,aspect=PFV	bakmadılar
bakmıyordunuz	pos=V,polar=POS,mood=IND,inter=DECL,tense=PRS,per=1,num=PL,aspect=PROG	bakıyoruz
bakmıyordunuz	pos=V,polar=POS,mood=IND,inter=DECL,tense=PST,per=3,num=PL,aspect={IPFV/PROG}	bakıyorlardı
bakmıyorsun	pos=V,polar=POS,mood=IND,inter=DECL,tense=PST,per=2,num=SG,aspect={IPFV/PROG}	bakıyordun
baldızımıza	pos=N,tense=PRS,per=3,num=SG,aspect={IPFV/PFV}	baldızlar
balığının	pos=N,tense=PRS,per=3,num=SG,aspect={IPFV/PFV}	balıklar
baltalarsınız	pos=N,tense=PRS,per=2,num=SG,aspect={IPFV/PFV}	baltasınız
barışıyorsun	pos=V,polar=POS,mood=IND,inter=DECL,tense=PST,per=3,num=SG,aspect={IPFV/PROG}	barışıyordu
barışıyoruz	pos=V,polar=POS,mood=IND,inter=DECL,tense=PRS,per=3,num=PL,aspect={IPFV/PFV}	barışırlar
barışmayacaklar	pos=V,polar=POS,mood=IND,inter=DECL,tense=PRS,per=1,num=SG,aspect=PROG	barışıyorum
barışmazlar	pos=V,polar=POS,mood=IND,inter=DECL,tense=PST,per=1,num=SG,aspect={IPFV/PROG}	barışıyordum
barışmıyorduk	pos=V,polar=NEG,mood=IND,inter=DECL,tense=PRS,per=2,num=SG,aspect={IPFV/PFV}	barışmazsın
başaracak	pos=V,polar=NEG,mood=IND,inter=DECL,tense=PST,per=2,num=SG,aspect=PFV	başarmadın
basarım	pos=V,polar=NEG,mood=IND,inter=DECL,tense=PST,per=2,num=PL,aspect=PFV	basmadınız
başarmayacaksın	pos=V,polar=NEG,mood=IND,inter=DECL,tense=PST,per=3,num=SG,aspect=PFV	başarmadı
basıyorlar	pos=V,polar=POS,mood=IND,inter=DECL,tense=PRS,per=2,num=PL,aspect={IPFV/PFV}	basarsınız
başkan	pos=N,tense=PRS,per=2,num=PL,aspect={IPFV/PFV}	başkanlarsınız
basmayacaklar	pos=V,polar=POS,mood=IND,inter=DECL,tense=PST,per=2,num=SG,aspect=PFV	bastın
basmayacaksın	pos=V,polar=POS,mood=IND,inter=DECL,tense=PRS,per=3,num=PL,aspect={IPFV/PFV}	basarlar
basmıyordu	pos=V,polar=NEG,mood=IND,inter=DECL,tense=PST,per=1,num=SG,aspect={IPFV/PROG}	basmıyordum
batmadım	pos=V,polar=NEG,mood=IND,inter=DECL,tense=PST,per=2,num=SG,aspect=PFV	batmadın
batmıyordum	pos=V,polar=NEG,mood=IND,inter=DECL,tense=PST,per=1,num=SG,aspect=PFV	batmadım
bayılacağız	pos=V,polar=NEG,mood=IND,inter=DECL,tense=PST,per=2,num=PL,aspect=PFV	bayılmadınız
bayılıyordunuz	pos=V,polar=POS,mood=IND,inter=DECL,tense=PRS,per=2,num=SG,aspect=PROG	bayılıyorsun
bayılmadınız	pos=V,polar=POS,mood=IND,inter=DECL,tense=PST,per=2,num=SG,aspect=PFV	bayıldın
bayılmayacaklar	pos=V,polar=POS,mood=IND,inter=DECL,tense=PST,per=1,num=SG,aspect=PFV	bayıldım
bayılmayacaklar	pos=V,polar=POS,mood=IND,inter=DECL,tense=PST,per=3,num=PL,aspect={IPFV/PROG}	bayılıyorlardı
bayılmıyordu	pos=V,polar=POS,mood=IND,inter=DECL,tense=PST,per=3,num=PL,aspect=PFV	bayıldılar
bayrağı	pos=N,tense=PRS,per=3,num=PL,aspect={IPFV/PFV}	bayraklardır
baytarlarınızın	pos=N,tense=PRS,per=3,num=PL,aspect={IPFV/PFV}	baytarlardır
bekledim	pos=V,polar=POS,mood=IND,inter=DECL,tense=PRS,per=3,num=SG,aspect={IPFV/PFV}	bekler
beklemiyorum	pos=V,polar=POS,mood=IND,inter=DECL,tense=PRS,per=2,num=PL,aspect={IPFV/PFV}	beklersiniz
bekleyecek	pos=V,polar=NEG,mood=IND,inter=DECL,tense=PRS,per=2,num=SG,aspect={IPFV/PFV}	beklemezsin
bekleyeceksiniz	pos=V,polar=NEG,mood=IND,inter=DECL,tense=PRS,per=3,num=SG,aspect={IPFV/PFV}	beklemez
beyittik	pos=N,tense=PRS,per=1,num=PL,aspect={IPFV/PFV}	beyitleriz
bıçakladık	pos=V,polar=NEG,mood=IND,inter=DECL,tense=PRS,per=2,num=PL,aspect={IPFV/PFV}	bıçaklamazsınız
bıçaklıyordunuz	pos=V,polar=NEG,mood=IND,inter=DECL,tense=PST,per=3,num=SG,aspect={IPFV/PROG}	bıçaklamıyordu
bıçaklıyordu	pos=V,polar=POS,mood=IND,inter=DECL,tense=PRS,per=3,num=SG,aspect={IPFV/PFV}	bıçaklar
bildirecek	pos=V,polar=NEG,mood=IND,inter=DECL,tense=PST,per=3,num=PL,aspect={IPFV/PROG}	bildirmiyordular
bildiriyoruz	pos=V,polar=NEG,mood=IND,inter=DECL,tense=PST,per=1,num=SG,aspect=PFV	bildirmedim
bildiriyoruz	pos=V,polar=NEG,mood=IND,inter=DECL,tense=PST,per=2,num=PL,aspect={IPFV/PROG}	bildirmiyordunuz
bildirmiyorsunuz	pos=V,polar=NEG,mood=IND,inter=DECL,tense=PRS,per=3,num=SG,aspect=PROG	bildirmiyor
biliyordu	pos=V,polar=POS,mood=IND,inter=DECL,tense=PRS,per=2,num=PL,aspect={IPFV/PFV}	bilirsiniz
biliyoruz	pos=V,polar=NEG,mood=IND,inter=DECL,tense=PRS,per=2,num=SG,aspect={IPFV/PFV}	bilmezsin
bilmezsiniz	pos=V,polar=POS,mood=IND,inter=DECL,tense=PRS,per=1,num=PL,aspect={IPFV/PFV}	biliriz
bilmiyorduk	pos=V,polar=POS,mood=IND,inter=DECL,tense=PRS,per=3,num=PL,aspect=PROG	biliyorlar
bilmiyordunuz	pos=V,polar=NEG,mood=IND,inter=DECL,tense=PRS,per=3,num=PL,aspect={IPFV/PFV}	bilmezler
bilmiyorum	pos=V,polar=NEG,mood=IND,inter=DECL,tense=PST,per=2,num=SG,aspect=PFV	bilmedin
bilyelermiş	pos=N,tense=PRS,per=2,num=SG,aspect={IPFV/PFV}	bilyesiniz
bindim	pos=V,polar=POS,mood=IND,inter=DECL,tense=PST,per=1,num=PL,aspect={IPFV/PROG}	biniyorduk
binersiniz	pos=V,polar=NEG,mood=IND,inter=DECL,tense=PRS,per=3,num=SG,aspect={IPFV/PFV}	binmez
binmedik	pos=V,polar=NEG,mood=IND,inter=DECL,tense=PRS,per=3,num=PL,aspect=PROG	binmiyorlar
binmedin	pos=V,polar=POS,mood=IND,inter=DECL,tense=PRS,per=3,num=SG,aspect={IPFV/PFV}	biner
bipledi	pos=V,tense=PRS,per=2,num=SG,aspect={IPFV/PFV}	biplersin
bipliyorlar	pos=V,tense=PRS,per=3,num=SG,aspect=PROG	bipliyor
birleşirim	pos=V,polar=NEG,mood=IND,inter=DECL,tense=PRS,per=2,num=PL,aspect=PROG	birleşmiyorsunuz
birleşiyor	pos=V,polar=NEG,mood=IND,inter=DECL,tense=PST,per=1,num=SG,aspect=PFV	birleşmedim
birleşmeyeceğiz	pos=V,polar=POS,mood=IND,inter=DECL,tense=PST,per=3,num=PL,aspect=PFV	birleştiler
birleşmezsin	pos=V,polar=NEG,mood=IND,inter=DECL,tense=PRS,per=1,num=PL,aspect={IPFV/PFV}	birleşmeyiz
birleşmiyor	pos=V,polar=NEG,mood=IND,inter=DECL,tense=PST,per=3,num=SG,aspect=PFV	birleşmedi
birleştirdik	pos=V,polar=NEG,mood=IND,inter=DECL,tense=PRS,per=1,num=SG,aspect=PROG	birleştirmiyorum
birleştirdim	pos=V,polar=NEG,mood=IND,inter=DECL,tense=PST,per=3,num=PL,aspect={IPFV/PROG}	birleştirmiyordular
birleştirdi	pos=V,polar=POS,mood=IND,inter=DECL,tense=PRS,per=1,num=SG,aspect=PROG	birleştiriyorum
birleştirirsiniz	pos=V,polar=POS,mood=IND,inter=DECL,tense=PRS,per=3,num=PL,aspect=PROG	birleştiriyorlar
birleştiriyordun	pos=V,polar=POS,mood=IND,inter=DECL,tense=PRS,per=3,num=PL,aspect=PROG	birleştiriyorlar
birleştiriyorum	pos=V,polar=POS,mood=IND,inter=DECL,tense=PST,per=1,num=PL,aspect=PFV	birleştirdik
birleştirmeyecek	pos=V,polar=POS,mood=IND,inter=DECL,tense=PRS,per=3,num=PL,aspect=PROG	birleştiriyorlar
birleştirmezsin	pos=V,polar=NEG,mood=IND,inter=DECL,tense=PRS,per=2,num=SG,aspect=PROG	birleştirmiyorsun
birleştirmiyordular	pos=V,polar=NEG,mood=IND,inter=DECL,tense=PST,per=2,num=SG,aspect={IPFV/PROG}	birleştirmiyordun
birleştirtecekler	pos=V,polar=POS,mood=IND,inter=DECL,tense=PRS,per=1,num=SG,aspect={IPFV/PFV}	birleştirtirim
birleştirtirsiniz	pos=V,polar=POS,mood=IND,inter=DECL,tense=PST,per=3,num=PL,aspect=PFV	birleştirtdiler
birleştirtiyordum	pos=V,polar=NEG,mood=IND,inter=DECL,tense=PST,per=2,num=PL,aspect=PFV	birleştirtmediniz
birleştirtiyordu	pos=V,polar=NEG,mood=IND,inter=DECL,tense=PST,per=2,num=SG,aspect={IPFV/PROG}	birleştirtmiyordun
birleştirtiyoruz	pos=V,polar=NEG,mood=IND,inter=DECL,tense=PRS,per=1,num=PL,aspect=PROG	birleştirtmiyoruz
birleştirtmediler	pos=V,polar=NEG,mood=IND,inter=DECL,tense=PRS,per=3,num=SG,aspect=PROG	birleştirtmiyor
birleştirtmediniz	pos=V,polar=POS,mood=IND,inter=DECL,tense=PRS,per=1,num=PL,aspect=PROG	birleştirtiyoruz
birleştirtmedin	pos=V,polar=POS,mood=IND,inter=DECL,tense=PST,per=3,num=PL,aspect=PFV	birleştirtdiler
birleştirtmiyorduk	pos=V,polar=NEG,mood=IND,inter=DECL,tense=PRS,per=3,num=SG,aspect=PROG	birleştirtmiyor
birleştirtmiyordunuz	pos=V,polar=POS,mood=IND,inter=DECL,tense=PST,per=1,num=PL,aspect={IPFV/PROG}	birleştirtiyorduk
bitireceksin	pos=V,polar=NEG,mood=IND,inter=DECL,tense=PST,per=2,num=SG,aspect={IPFV/PROG}	bitirmiyordun
bitiriyoruz	pos=V,polar=NEG,mood=IND,inter=DECL,tense=PRS,per=3,num=PL,aspect=PROG	bitirmiyorlar
bitiriyoruz	pos=V,polar=NEG,mood=IND,inter=DECL,tense=PST,per=3,num=PL,aspect={IPFV/PROG}	bitirmiyordular
bitirmeyeceğim	pos=V,polar=POS,mood=IND,inter=DECL,tense=PRS,per=1,num=SG,aspect=PROG	bitiriyorum
bitirtecekler	pos=V,polar=NEG,mood=IND,inter=DECL,tense=PRS,per=2,num=SG,aspect={IPFV/PFV}	bitirtmezsin
bitirtirsiniz	pos=V,polar=POS,mood=IND,inter=DECL,tense=PRS,per=1,num=PL,aspect={IPFV/PFV}	bitirtiriz
bitirtiyorlar	pos=V,polar=POS,mood=IND,inter=DECL,tense=PST,per=1,num=SG,aspect={IPFV/PROG}	bitirtiyordum
bitirtmeyecek	pos=V,polar=POS,mood=IND,inter=DECL,tense=PRS,per=3,num=SG,aspect={IPFV/PFV}	bitirtir
bitirtmeyeceksin	pos=V,polar=NEG,mood=IND,inter=DECL,tense=PST,per=1,num=PL,aspect=PFV	bitirtmedik
bitirtmiyordular	pos=V,polar=POS,mood=IND,inter=DECL,tense=PST,per=3,num=PL,aspect={IPFV/PROG}	bitirtiyorlardı
bitirtmiyordunuz	pos=V,polar=NEG,mood=IND,inter=DECL,tense=PRS,per=2,num=SG,aspect={IPFV/PFV}	bitirtmezsin
bitirttirdim	pos=V,polar=NEG,mood=IND,inter=DECL,tense=PST,per=3,num=SG,aspect=PFV	bitirttirmedi
bitirttireceksiniz	pos=V,polar=POS,mood=IND,inter=DECL,tense=PST,per=2,num=PL,aspect={IPFV/PROG}	bitirttiriyordunuz
bitirttirmiyordun	pos=V,polar=NEG,mood=IND,inter=DECL,tense=PRS,per=2,num=PL,aspect=PROG	bitirttirmiyorsunuz
bitmediniz	pos=V,polar=POS,mood=IND,inter=DECL,tense=PRS,per=2,num=SG,aspect=PROG	bitiyorsun
bitmiyordunuz	pos=V,polar=POS,mood=IND,inter=DECL,tense=PRS,per=1,num=PL,aspect=PROG	bitiyoruz
bitmiyorsun	pos=V,polar=NEG,mood=IND,inter=DECL,tense=PRS,per=2,num=SG,aspect={IPFV/PFV}	bitmezsin
bittim	pos=V,polar=NEG,mood=IND,inter=DECL,tense=PST,per=3,num=PL,aspect=PFV	bitmediler
böğürtlenlerdik	pos=N,tense=PRS,per=1,num=SG,aspect={IPFV/PFV}	böğürtleniz
bohçalarda	pos=N,tense=PRS,per=3,num=SG,aspect={IPFV/PFV}	bohçalar
bölerler	pos=V,polar=POS,mood=IND,inter=DECL,tense=PST,per=2,num=PL,aspect={IPFV/PROG}	bölüyordunuz
bölgelerimden	pos=N,tense=PRS,per=3,num=PL,aspect={IPFV/PFV}	bölgelerdir
bölmüyorum	pos=V,polar=POS,mood=IND,inter=DECL,tense=PST,per=2,num=SG,aspect=PFV	böltün
bölüyordun	pos=V,polar=POS,mood=IND,inter=DECL,tense=PST,per=3,num=SG,aspect=PFV	böltü
boşalmadı	pos=V,polar=POS,mood=IND,inter=DECL,tense=PST,per=2,num=SG,aspect={IPFV/PROG}	boşalıyordun
boşalmazsınız	pos=V,polar=POS,mood=IND,inter=DECL,tense=PST,per=3,num=PL,aspect=PFV	boşaldılar
boşalmıyordum	pos=V,polar=NEG,mood=IND,inter=DECL,tense=PRS,per=2,num=SG,aspect={IPFV/PFV}	boşalmazsın
boşandık	pos=V,polar=NEG,mood=IND,inter=DECL,tense=PST,per=2,num=PL,aspect=PFV	boşanmadınız
boşanmadın	pos=V,polar=NEG,mood=IND,inter=DECL,tense=PST,per=3,num=PL,aspect={IPFV/PROG}	boşanmıyordular
boşanmadı	pos=V,polar=POS,mood=IND,inter=DECL,tense=PRS,per=3,num=SG,aspect=PROG	boşanıyor
boşanmıyordu	pos=V,polar=POS,mood=IND,inter=DECL,tense=PRS,per=1,num=PL,aspect={IPFV/PFV}	boşanırız
boşanmıyorum	pos=V,polar=NEG,mood=IND,inter=DECL,tense=PST,per=3,num=SG,aspect=PFV	boşanmadı
boyamadınız	pos=V,polar=POS,mood=IND,inter=DECL,tense=PST,per=2,num=SG,aspect={IPFV/PROG}	boyuyordun
boyamadın	pos=V,polar=NEG,mood=IND,inter=DECL,tense=PST,per=3,num=PL,aspect={IPFV/PROG}	boyamıyordular
boyamayız	pos=V,polar=NEG,mood=IND,inter=DECL,tense=PST,per=3,num=SG,aspect={IPFV/PROG}	boyamıyordu
boyarız	pos=V,polar=NEG,mood=IND,inter=DECL,tense=PRS,per=2,num=PL,aspect={IPFV/PFV}	boyamazsınız
boyuyorlardı	pos=V,polar=POS,mood=IND,inter=DECL,tense=PRS,per=3,num=SG,aspect=PROG	boyuyor
bozayıdan	pos=N,tense=PRS,per=2,num=PL,aspect={IPFV/PFV}	bozayılarsınız
bozmam	pos=V,polar=POS,mood=IND,inter=DECL,tense=PST,per=3,num=PL,aspect=PFV	bozdular
bozuyorsun	pos=V,polar=NEG,mood=IND,inter=DECL,tense=PRS,per=3,num=SG,aspect={IPFV/PFV}	bozmaz
buharlaşacak	pos=V,polar=POS,mood=IND,inter=DECL,tense=PST,per=1,num=PL,aspect={IPFV/PROG}	buharlaşıyorduk
buharlaşmadım	pos=V,polar=NEG,mood=IND,inter=DECL,tense=PST,per=2,num=SG,aspect=PFV	buharlaşmadın
buharlaşmayacak	pos=V,polar=NEG,mood=IND,inter=DECL,tense=PRS,per=2,num=SG,aspect={IPFV/PFV}	buharlaşmazsın
buharlaşmaz	pos=V,polar=NEG,mood=IND,inter=DECL,tense=PST,per=3,num=SG,aspect=PFV	buharlaşmadı
buharlaşmıyordum	pos=V,polar=POS,mood=IND,inter=DECL,tense=PST,per=3,num=SG,aspect={IPFV/PROG}	buharlaşıyordu
büker	pos=V,polar=NEG,mood=IND,inter=DECL,tense=PRS,per=1,num=PL,aspect={IPFV/PFV}	bükmeyiz
büktürmeyiz	pos=V,polar=NEG,mood=IND,inter=DECL,tense=PST,per=2,num=SG,aspect={IPFV/PROG}	büktürmüyordun
büktürmezsiniz	pos=V,polar=POS,mood=IND,inter=DECL,tense=PST,per=2,num=SG,aspect=PFV	büktürtün
büktürteceğiz	pos=V,polar=POS,mood=IND,inter=DECL,tense=PST,per=1,num=PL,aspect={IPFV/PROG}	büktürtüyorduk
büktürtmediniz	pos=V,polar=POS,mood=IND,inter=DECL,tense=PRS,per=3,num=PL,aspect=PROG	büktürtüyorlar
büktürtmüyor	pos=V,polar=POS,mood=IND,inter=DECL,tense=PRS,per=3,num=SG,aspect={IPFV/PFV}	büktürtür
büktürtmüyorum	pos=V,polar=NEG,mood=IND,inter=DECL,tense=PST,per=1,num=PL,aspect={IPFV/PROG}	büktürtmüyorduk
büktürtüleceğim	pos=V,polar=POS,mood=IND,inter=DECL,tense=PST,per=2,num=SG,aspect={IPFV/PROG}	büktürtülüyordun
büktürtülmedin	pos=V,polar=POS,mood=IND,inter=DECL,tense=PRS,per=3,num=SG,aspect=PROG	büktürtülüyor
büktürtülmeyecek	pos=V,polar=NEG,mood=IND,inter=DECL,tense=PST,per=1,num=SG,aspect={IPFV/PROG}	büktürtülmüyordum
büktürtülmeyecek	pos=V,polar=POS,mood=IND,inter=DECL,tense=PRS,per=3,num=PL,aspect=PROG	büktürtülüyorlar
büktürtülmezsiniz	pos=V,polar=POS,mood=IND,inter=DECL,tense=PRS,per=2,num=PL,aspect=PROG	büktürtülüyorsunuz
büktürtürsünüz	pos=V,polar=POS,mood=IND,inter=DECL,tense=PRS,per=3,num=PL,aspect=PROG	büktürtüyorlar
büktürtüyorduk	pos=V,polar=NEG,mood=IND,inter=DECL,tense=PRS,per=3,num=PL,aspect={IPFV/PFV}	büktürtmezler
büktürtüyorlardı	pos=V,polar=POS,mood=IND,inter=DECL,tense=PRS,per=1,num=SG,aspect=PROG	büktürtüyorum
büktürtüyorum	pos=V,polar=POS,mood=IND,inter=DECL,tense=PST,per=2,num=SG,aspect={IPFV/PROG}	büktürtüyordun
büktürtüyoruz	pos=V,polar=POS,mood=IND,inter=DECL,tense=PRS,per=3,num=PL,aspect=PROG	büktürtüyorlar
büktürülmem	pos=V,polar=NEG,mood=IND,inter=DECL,tense=PRS,per=3,num=PL,aspect=PROG	büktürülmüyorlar
büktürülmüyorlar	pos=V,polar=POS,mood=IND,inter=DECL,tense=PRS,per=3,num=SG,aspect={IPFV/PFV}	büktürülür
büktürülüyordun	pos=V,polar=POS,mood=IND,inter=DECL,tense=PRS,per=2,num=PL,aspect={IPFV/PFV}	büktürülürsünüz
büktürürsün	pos=V,polar=POS,mood=IND,inter=DECL,tense=PRS,per=3,num=SG,aspect=PROG	büktürüyor
büktürürüz	pos=V,polar=POS,mood=IND,inter=DECL,tense=PST,per=3,num=PL,aspect=PFV	büktürtüler
büküldü	pos=V,polar=POS,mood=IND,inter=DECL,tense=PRS,per=1,num=PL,aspect={IPFV/PFV}	bükülüriz
büküleceksiniz	pos=V,polar=NEG,mood=IND,inter=DECL,tense=PRS,per=2,num=PL,aspect={IPFV/PFV}	bükülmezsiniz
bükülüyorsunuz	pos=V,polar=POS,mood=IND,inter=DECL,tense=PST,per=3,num=SG,aspect={IPFV/PROG}	bükülüyordu
büküyor	pos=V,polar=POS,mood=IND,inter=DECL,tense=PST,per=3,num=PL,aspect=PFV	büktüler
bulacağım	pos=V,polar=POS,mood=IND,inter=DECL,tense=PRS,per=3,num=PL,aspect={IPFV/PFV}	bulurlar
bulacak	pos=V,polar=NEG,mood=IND,inter=DECL,tense=PST,per=2,num=PL,aspect=PFV	bulmadınız
bulmayacaksınız	pos=V,polar=POS,mood=IND,inter=DECL,tense=PRS,per=1,num=SG,aspect={IPFV/PFV}	bulurum
bulmuyordun	pos=V,polar=POS,mood=IND,inter=DECL,tense=PST,per=2,num=SG,aspect=PFV	buldun
bulmuyor	pos=V,polar=NEG,mood=IND,inter=DECL,tense=PRS,per=2,num=SG,aspect=PROG	bulmuyorsun
bulunmadım	pos=V,polar=POS,mood=IND,inter=DECL,tense=PST,per=2,num=SG,aspect=PFV	bulundun
bulunmadı	pos=V,polar=NEG,mood=IND,inter=DECL,tense=PRS,per=2,num=SG,aspect=PROG	bulunmuyorsun
bulunmuyordum	pos=V,polar=NEG,mood=IND,inter=DECL,tense=PST,per=3,num=PL,aspect={IPFV/PROG}	bulunmuyordular
bulunurlar	pos=V,polar=POS,mood=IND,inter=DECL,tense=PST,per=3,num=SG,aspect=PFV	bulundu
bulunuyor	pos=V,polar=NEG,mood=IND,inter=DECL,tense=PRS,per=3,num=PL,aspect={IPFV/PFV}	bulunmazlar
bulurlar	pos=V,polar=POS,mood=IND,inter=DECL,tense=PRS,per=2,num=SG,aspect={IPFV/PFV}	bulursun
bulursunuz	pos=V,polar=NEG,mood=IND,inter=DECL,tense=PST,per=3,num=PL,aspect={IPFV/PROG}	bulmuyordular
buluşacağım	pos=V,polar=NEG,mood=IND,inter=DECL,tense=PST,per=1,num=PL,aspect=PFV	buluşmadık
buluşacaksın	pos=V,polar=POS,mood=IND,inter=DECL,tense=PRS,per=2,num=SG,aspect={IPFV/PFV}	buluşursun
buluşmayacak	pos=V,polar=POS,mood=IND,inter=DECL,tense=PRS,per=1,num=PL,aspect=PROG	buluşuyoruz
buluşmayacak	pos=V,polar=POS,mood=IND,inter=DECL,tense=PST,per=2,num=PL,aspect=PFV	buluştunuz
buluşmuyordular	pos=V,polar=POS,mood=IND,inter=DECL,tense=PST,per=3,num=PL,aspect={IPFV/PROG}	buluşuyorlardı
buluşmuyordu	pos=V,polar=NEG,mood=IND,inter=DECL,tense=PRS,per=3,num=SG,aspect=PROG	buluşmuyor
buluştun	pos=V,polar=NEG,mood=IND,inter=DECL,tense=PRS,per=3,num=PL,aspect={IPFV/PFV}	buluşmazlar
buluşursunuz	pos=V,polar=NEG,mood=IND,inter=DECL,tense=PRS,per=3,num=PL,aspect={IPFV/PFV}	buluşmazlar
buluyorum	pos=V,tense=PRS,per=3,num=SG,aspect=PROG	buluyor
bütünleşecek	pos=V,polar=POS,mood=IND,inter=DECL,tense=PST,per=2,num=SG,aspect=PFV	bütünleştin
bütünleşiyordunuz	pos=V,polar=NEG,mood=IND,inter=DECL,tense=PRS,per=2,num=SG,aspect={IPFV/PFV}	bütünleşmezsin
bütünleşiyorsun	pos=V,polar=POS,mood=IND,inter=DECL,tense=PST,per=3,num=PL,aspect={IPFV/PROG}	bütünleşiyorlardı
bütünleşmeyiz	pos=V,polar=NEG,mood=IND,inter=DECL,tense=PRS,per=1,num=SG,aspect={IPFV/PFV}	bütünleşmem
bütünleşmezler	pos=V,polar=NEG,mood=IND,inter=DECL,tense=PRS,per=2,num=PL,aspect={IPFV/PFV}	bütünleşmezsiniz
çağanozduk	pos=N,tense=PRS,per=3,num=SG,aspect={IPFV/PFV}	çağanozlar
çağanozunu	pos=N,tense=PRS,per=1,num=PL,aspect={IPFV/PFV}	çağanozlarız
çağırıyor	pos=V,polar=NEG,mood=IND,inter=DECL,tense=PST,per=1,num=SG,aspect={IPFV/PROG}	çağırmıyordum
çağırmayacağım	pos=V,polar=POS,mood=IND,inter=DECL,tense=PST,per=2,num=SG,aspect={IPFV/PROG}	çağırıyordun
çağırmıyorum	pos=V,polar=POS,mood=IND,inter=DECL,tense=PST,per=3,num=SG,aspect={IPFV/PROG}	çağırıyordu
çalarsınız	pos=V,polar=POS,mood=IND,inter=DECL,tense=PST,per=2,num=PL,aspect=PFV	çaldınız
çalışacağım	pos=V,polar=NEG,mood=IND,inter=DECL,tense=PRS,per=2,num=SG,aspect={IPFV/PFV}	çalışmazsın
çalışmayacağım	pos=V,polar=POS,mood=IND,inter=DECL,tense=PST,per=1,num=PL,aspect=PFV	çalıştık
çalışmazlar	pos=V,polar=POS,mood=IND,inter=DECL,tense=PST,per=2,num=PL,aspect=PFV	çalıştınız
çalışmıyor	pos=V,polar=NEG,mood=IND,inter=DECL,tense=PST,per=1,num=SG,aspect={IPFV/PROG}	çalışmıyordum
çalışmıyorsun	pos=V,polar=NEG,mood=IND,inter=DECL,tense=PRS,per=3,num=PL,aspect=PROG	çalışmıyorlar
çalıyor	pos=V,polar=NEG,mood=IND,inter=DECL,tense=PRS,per=3,num=SG,aspect=PROG	çalmıyor
çalmazsın	pos=V,polar=POS,mood=IND,inter=DECL,tense=PRS,per=2,num=PL,aspect={IPFV/PFV}	çalarsınız
canlanacağım	pos=V,polar=POS,mood=IND,inter=DECL,tense=PRS,per=1,num=PL,aspect=PROG	canlanıyoruz
canlanacak	pos=V,polar=NEG,mood=IND,inter=DECL,tense=PST,per=1,num=PL,aspect=PFV	canlanmadık
canlandık	pos=V,polar=NEG,mood=IND,inter=DECL,tense=PST,per=1,num=SG,aspect=PFV	canlanmadım
canlandım	pos=V,polar=POS,mood=IND,inter=DECL,tense=PRS,per=1,num=PL,aspect=PROG	canlanıyoruz
canlandın	pos=V,polar=NEG,mood=IND,inter=DECL,tense=PRS,per=1,num=PL,aspect={IPFV/PFV}	canlanmayız
canlandırdı	pos=V,polar=POS,mood=IND,inter=DECL,tense=PRS,per=2,num=PL,aspect={IPFV/PFV}	canlandırırsınız
canlandırılırsınız	pos=V,polar=NEG,mood=IND,inter=DECL,tense=PST,per=1,num=PL,aspect={IPFV/PROG}	canlandırılmıyorduk
canlandırılırsın	pos=V,polar=NEG,mood=IND,inter=DECL,tense=PRS,per=1,num=SG,aspect=PROG	canlandırılmıyorum
canlandırılmadın	pos=V,polar=POS,mood=IND,inter=DECL,tense=PRS,per=2,num=PL,aspect=PROG	canlandırılıyorsunuz
canlandırılmıyordun	pos=V,polar=POS,mood=IND,inter=DECL,tense=PRS,per=3,num=SG,aspect={IPFV/PFV}	canlandırılır
canlandırmıyorduk	pos=V,polar=NEG,mood=IND,inter=DECL,tense=PST,per=3,num=PL,aspect={IPFV/PROG}	canlandırmıyordular
canlandırmıyor	pos=V,polar=NEG,mood=IND,inter=DECL,tense=PST,per=3,num=PL,aspect={IPFV/PROG}	canlandırmıyordular
canlandırtacağım	pos=V,polar=POS,mood=IND,inter=DECL,tense=PRS,per=2,num=SG,aspect=PROG	canlandırtıyorsun
canlandırtılırlar	pos=V,polar=POS,mood=IND,inter=DECL,tense=PRS,per=2,num=PL,aspect=PROG	canlandırtılıyorsunuz
canlandırtılıyordu	pos=V,polar=POS,mood=IND,inter=DECL,tense=PST,per=3,num=PL,aspect=PFV	canlandırtıltılar
canlandırtıyordum	pos=V,polar=POS,mood=IND,inter=DECL,tense=PST,per=1,num=PL,aspect={IPFV/PROG}	canlandırtıyorduk
canlandırtıyorlardı	pos=V,polar=POS,mood=IND,inter=DECL,tense=PRS,per=3,num=PL,aspect=PROG	canlandırtıyorlar
canlandırtmayacaklar	pos=V,polar=NEG,mood=IND,inter=DECL,tense=PRS,per=2,num=PL,aspect={IPFV/PFV}	canlandırtmazsınız
canlandırtmıyorlar	pos=V,polar=POS,mood=IND,inter=DECL,tense=PRS,per=2,num=PL,aspect={IPFV/PFV}	canlandırtırsınız
canlanılacak	pos=V,polar=NEG,mood=IND,inter=DECL,tense=PRS,per=2,num=SG,aspect=PROG	canlanılmıyorsun
canlanılıyorsun	pos=V,polar=POS,mood=IND,inter=DECL,tense=PRS,per=3,num=SG,aspect=PROG	canlanılıyor
canlanıltım	pos=V,polar=POS,mood=IND,inter=DECL,tense=PST,per=3,num=PL,aspect=PFV	canlanıltılar
canlanmaıyorlar	pos=V,polar=POS,mood=IND,inter=DECL,tense=PRS,per=1,num=SG,aspect={IPFV/PFV}	canlanmazım
canlanmaıyorlar	pos=V,polar=POS,mood=IND,inter=DECL,tense=PST,per=3,num=SG,aspect=PFV	canlanmadı
canlanmaıyor	pos=V,polar=POS,mood=IND,inter=DECL,tense=PRS,per=2,num=PL,aspect=PROG	canlanmaıyorsunuz
canlanmaıyorsun	pos=V,polar=POS,mood=IND,inter=DECL,tense=PRS,per=1,num=PL,aspect=PROG	canlanmaıyoruz
canlanmamayız	pos=V,polar=NEG,mood=IND,inter=DECL,tense=PRS,per=2,num=PL,aspect={IPFV/PFV}	canlanmamazsınız
canlanmamıyorsunuz	pos=V,polar=NEG,mood=IND,inter=DECL,tense=PST,per=3,num=PL,aspect={IPFV/PROG}	canlanmamıyordular
canlanmamıyorum	pos=V,polar=NEG,mood=IND,inter=DECL,tense=PRS,per=2,num=SG,aspect=PROG	canlanmamıyorsun
canlanmam	pos=V,polar=POS,mood=IND,inter=DECL,tense=PRS,per=1,num=PL,aspect=PROG	canlanıyoruz
canlanmıyordular	pos=V,polar=NEG,mood=IND,inter=DECL,tense=PST,per=2,num=PL,aspect={IPFV/PROG}	canlanmıyordunuz
canlanmıyor	pos=V,polar=NEG,mood=IND,inter=DECL,tense=PRS,per=1,num=PL,aspect=PROG	canlanmıyoruz
canlanmıyorsun	pos=V,polar=POS,mood=IND,inter=DECL,tense=PRS,per=2,num=SG,aspect=PROG	canlanıyorsun
çantasından	pos=N,tense=PRS,per=3,num=PL,aspect={IPFV/PFV}	çantalardır
çapandan	pos=N,tense=PRS,per=1,num=PL,aspect={IPFV/PFV}	çapalarız
çapta	pos=N,tense=PRS,per=1,num=SG,aspect={IPFV/PFV}	çapız
çarpacaksın	pos=V,polar=NEG,mood=IND,inter=DECL,tense=PRS,per=1,num=PL,aspect={IPFV/PFV}	çarpmayız
çarpıyordum	pos=V,polar=POS,mood=IND,inter=DECL,tense=PST,per=3,num=PL,aspect={IPFV/PROG}	çarpıyorlardı
çarpmadım	pos=V,polar=NEG,mood=IND,inter=DECL,tense=PST,per=3,num=PL,aspect=PFV	çarpmadılar
çarpmayacak	pos=V,polar=POS,mood=IND,inter=DECL,tense=PST,per=3,num=PL,aspect=PFV	çarptılar
çarpmayız	pos=V,polar=POS,mood=IND,inter=DECL,tense=PRS,per=2,num=SG,aspect={IPFV/PFV}	çarparsın
çekiyordu	pos=V,polar=NEG,mood=IND,inter=DECL,tense=PST,per=1,num=SG,aspect=PFV	çekmedim
çekmedim	pos=V,polar=POS,mood=IND,inter=DECL,tense=PRS,per=1,num=SG,aspect={IPFV/PFV}	çekerim
çekmeyecekler	pos=V,polar=POS,mood=IND,inter=DECL,tense=PRS,per=1,num=PL,aspect=PROG	çekiyoruz
çekmiyorum	pos=V,polar=NEG,mood=IND,inter=DECL,tense=PST,per=3,num=SG,aspect=PFV	çekmedi
çektin	pos=V,polar=NEG,mood=IND,inter=DECL,tense=PST,per=1,num=PL,aspect={IPFV/PROG}	çekmiyorduk
cepheleri	pos=N,tense=PRS,per=2,num=SG,aspect={IPFV/PFV}	cephesiniz
cezalandıracağız	pos=V,polar=POS,mood=IND,inter=DECL,tense=PRS,per=3,num=SG,aspect=PROG	cezalandırıyor
cezalandırırım	pos=V,polar=POS,mood=IND,inter=DECL,tense=PST,per=1,num=SG,aspect={IPFV/PROG}	cezalandırıyordum
cezalandırmayacaksın	pos=V,polar=NEG,mood=IND,inter=DECL,tense=PRS,per=1,num=SG,aspect={IPFV/PFV}	cezalandırmam
çığırtkanın	pos=N,tense=PRS,per=1,num=PL,aspect={IPFV/PFV}	çığırtkanlarız
çıkarırız	pos=V,polar=POS,mood=IND,inter=DECL,tense=PRS,per=3,num=PL,aspect=PROG	çıkarıyorlar
çıkarmadınız	pos=V,polar=POS,mood=IND,inter=DECL,tense=PST,per=3,num=PL,aspect=PFV	çıkardılar
çıkarmıyorlar	pos=V,polar=POS,mood=IND,inter=DECL,tense=PRS,per=2,num=SG,aspect={IPFV/PFV}	çıkarırsın
çıkıyordun	pos=V,polar=NEG,mood=IND,inter=DECL,tense=PST,per=1,num=PL,aspect={IPFV/PROG}	çıkmıyorduk
çıldırmayacaklar	pos=V,polar=POS,mood=IND,inter=DECL,tense=PST,per=1,num=SG,aspect=PFV	çıldırdım
çıldırmayacaksınız	pos=V,polar=POS,mood=IND,inter=DECL,tense=PST,per=2,num=SG,aspect=PFV	çıldırdın
çıldırmıyorduk	pos=V,polar=POS,mood=IND,inter=DECL,tense=PST,per=3,num=SG,aspect=PFV	çıldırdı
çıldırmıyor	pos=V,polar=NEG,mood=IND,inter=DECL,tense=PRS,per=3,num=PL,aspect={IPFV/PFV}	çıldırmazlar
cindiniz	pos=N,tense=PRS,per=1,num=PL,aspect={IPFV/PFV}	cinleriz
çırağız	pos=N,tense=PRS,per=3,num=SG,aspect={IPFV/PFV}	çıraklar
cisminize	pos=N,tense=PRS,per=1,num=PL,aspect={IPFV/PFV}	cisimleriz
çizeceğim	pos=V,polar=POS,mood=IND,inter=DECL,tense=PRS,per=2,num=SG,aspect={IPFV/PFV}	çizersin
çizerim	pos=V,polar=NEG,mood=IND,inter=DECL,tense=PST,per=2,num=PL,aspect={IPFV/PROG}	çizmiyordunuz
çizmeyeceksiniz	pos=V,polar=NEG,mood=IND,inter=DECL,tense=PRS,per=3,num=SG,aspect={IPFV/PFV}	çizmez
çizmezsin	pos=V,polar=NEG,mood=IND,inter=DECL,tense=PRS,per=3,num=SG,aspect={IPFV/PFV}	çizmez
çizmiyoruz	pos=V,polar=POS,mood=IND,inter=DECL,tense=PST,per=1,num=SG,aspect=PFV	çizdim
çökeleğinden	pos=N,tense=PRS,per=2,num=SG,aspect={IPFV/PFV}	çökeleksiniz
çökereceksin	pos=V,polar=NEG,mood=IND,inter=DECL,tense=PST,per=1,num=PL,aspect={IPFV/PROG}	çökermiyorduk
çökeririm	pos=V,polar=NEG,mood=IND,inter=DECL,tense=PST,per=3,num=PL,aspect={IPFV/PROG}	çökermiyordular
çökerteceğim	pos=V,polar=NEG,mood=IND,inter=DECL,tense=PST,per=1,num=PL,aspect={IPFV/PROG}	çökertmiyorduk
çökertiyordum	pos=V,polar=NEG,mood=IND,inter=DECL,tense=PST,per=3,num=SG,aspect=PFV	çökertmedi
çökertmeyecekler	pos=V,polar=NEG,mood=IND,inter=DECL,tense=PST,per=2,num=PL,aspect={IPFV/PROG}	çökertmiyordunuz
çökerttiniz	pos=V,polar=NEG,mood=IND,inter=DECL,tense=PST,per=3,num=SG,aspect=PFV	çökertmedi
çürüdün	pos=V,polar=POS,mood=IND,inter=DECL,tense=PST,per=3,num=SG,aspect={IPFV/PROG}	çürüyordu
çürüdünüz	pos=V,polar=NEG,mood=IND,inter=DECL,tense=PST,per=3,num=SG,aspect=PFV	çürümedi
çürümedi	pos=V,polar=NEG,mood=IND,inter=DECL,tense=PRS,per=2,num=SG,aspect=PROG	çürümüyorsun
çürümeyeceksiniz	pos=V,polar=POS,mood=IND,inter=DECL,tense=PRS,per=1,num=PL,aspect=PROG	çürüyoruz
dağılmıyordunuz	pos=V,polar=POS,mood=IND,inter=DECL,tense=PST,per=1,num=PL,aspect=PFV	dağıldık
dağıtacak	pos=V,polar=NEG,mood=IND,inter=DECL,tense=PST,per=2,num=SG,aspect={IPFV/PROG}	dağıtmıyordun
dağıtırsın	pos=V,polar=POS,mood=IND,inter=DECL,tense=PRS,per=3,num=SG,aspect=PROG	dağıtıyor
dağıtıyorlardı	pos=V,polar=POS,mood=IND,inter=DECL,tense=PST,per=3,num=SG,aspect=PFV	dağıttı
dağıtmayacağız	pos=V,polar=POS,mood=IND,inter=DECL,tense=PRS,per=2,num=SG,aspect=PROG	dağıtıyorsun
dağıtmaz	pos=V,polar=POS,mood=IND,inter=DECL,tense=PST,per=1,num=SG,aspect={IPFV/PROG}	dağıtıyordum
dağıtmıyordun	pos=V,polar=POS,mood=IND,inter=DECL,tense=PST,per=3,num=PL,aspect={IPFV/PROG}	dağıtıyorlardı
dağıtmıyordunuz	pos=V,polar=NEG,mood=IND,inter=DECL,tense=PST,per=3,num=SG,aspect=PFV	dağıtmadı
dağıttık	pos=V,polar=NEG,mood=IND,inter=DECL,tense=PRS,per=2,num=SG,aspect={IPFV/PFV}	dağıtmazsın
dalarlar	pos=V,polar=POS,mood=IND,inter=DECL,tense=PRS,per=2,num=PL,aspect=PROG	dalıyorsunuz
dalar	pos=V,polar=NEG,mood=IND,inter=DECL,tense=PST,per=3,num=PL,aspect=PFV	dalmadılar
daldın	pos=V,polar=POS,mood=IND,inter=DECL,tense=PST,per=1,num=PL,aspect=PFV	daldık
daldırmayacaksınız	pos=V,polar=NEG,mood=IND,inter=DECL,tense=PRS,per=1,num=PL,aspect=PROG	daldırmıyoruz
daldırmıyorum	pos=V,polar=POS,mood=IND,inter=DECL,tense=PRS,per=3,num=SG,aspect={IPFV/PFV}	daldırır
daldırtacağız	pos=V,polar=POS,mood=IND,inter=DECL,tense=PST,per=2,num=SG,aspect={IPFV/PROG}	daldırtıyordun
daldırtdınız	pos=V,polar=NEG,mood=IND,inter=DECL,tense=PST,per=2,num=PL,aspect={IPFV/PROG}	daldırtmıyordunuz
daldırtmayacağım	pos=V,polar=POS,mood=IND,inter=DECL,tense=PRS,per=3,num=SG,aspect={IPFV/PFV}	daldırtır
daldırtmayacak	pos=V,polar=NEG,mood=IND,inter=DECL,tense=PRS,per=2,num=SG,aspect={IPFV/PFV}	daldırtmazsın
daldırtmayacak	pos=V,polar=NEG,mood=IND,inter=DECL,tense=PST,per=2,num=PL,aspect=PFV	daldırtmadınız
daldırtmayız	pos=V,polar=NEG,mood=IND,inter=DECL,tense=PRS,per=2,num=PL,aspect={IPFV/PFV}	daldırtmazsınız
dalgalandıracaklar	pos=V,polar=NEG,mood=IND,inter=DECL,tense=PST,per=1,num=PL,aspect={IPFV/PROG}	dalgalandırmıyorduk
dalgalandıracaksınız	pos=V,polar=POS,mood=IND,inter=DECL,tense=PRS,per=1,num=PL,aspect={IPFV/PFV}	dalgalandırırız
dalgalandırdılar	pos=V,polar=POS,mood=IND,inter=DECL,tense=PST,per=3,num=PL,aspect={IPFV/PROG}	dalgalandırıyorlardı
dalgalandırdı	pos=V,polar=NEG,mood=IND,inter=DECL,tense=PRS,per=3,num=PL,aspect={IPFV/PFV}	dalgalandırmazlar
dalgalandırırlar	pos=V,polar=POS,mood=IND,inter=DECL,tense=PRS,per=2,num=SG,aspect=PROG	dalgalandırıyorsun
dalgalandırmayacağım	pos=V,polar=POS,mood=IND,inter=DECL,tense=PRS,per=2,num=PL,aspect={IPFV/PFV}	dalgalandırırsınız
dalgalandırmazlar	pos=V,polar=NEG,mood=IND,inter=DECL,tense=PST,per=2,num=SG,aspect={IPFV/PROG}	dalgalandırmıyordun
dalgalandırmazsın	pos=V,polar=NEG,mood=IND,inter=DECL,tense=PST,per=3,num=SG,aspect=PFV	dalgalandırmadı
dalgalanıyorsunuz	pos=V,polar=POS,mood=IND,inter=DECL,tense=PRS,per=1,num=SG,aspect={IPFV/PFV}	dalgalanırım
dalmayacaksınız	pos=V,polar=POS,mood=IND,inter=DECL,tense=PST,per=1,num=SG,aspect={IPFV/PROG}	dalıyordum
darılacak	pos=V,polar=NEG,mood=IND,inter=DECL,tense=PRS,per=2,num=SG,aspect=PROG	darılmıyorsun
darılır	pos=V,polar=NEG,mood=IND,inter=DECL,tense=PRS,per=1,num=PL,aspect=PROG	darılmıyoruz
darılmayacaksın	pos=V,polar=NEG,mood=IND,inter=DECL,tense=PST,per=3,num=SG,aspect={IPFV/PROG}	darılmıyordu
darılmıyoruz	pos=V,polar=POS,mood=IND,inter=DECL,tense=PRS,per=2,num=PL,aspect={IPFV/PFV}	darılırsınız
değişmiyorduk	pos=V,polar=POS,mood=IND,inter=DECL,tense=PST,per=1,num=SG,aspect={IPFV/PROG}	değişiyordum
değişmiyordum	pos=V,polar=NEG,mood=IND,inter=DECL,tense=PST,per=3,num=PL,aspect=PFV	değişmediler
değiştirdin	pos=V,polar=POS,mood=IND,inter=DECL,tense=PRS,per=1,num=PL,aspect=PROG	değiştiriyoruz
değiştiriyordun	pos=V,polar=NEG,mood=IND,inter=DECL,tense=PRS,per=2,num=SG,aspect=PROG	değiştirmiyorsun
değiştirmiyordunuz	pos=V,polar=POS,mood=IND,inter=DECL,tense=PRS,per=1,num=PL,aspect=PROG	değiştiriyoruz
değiştirmiyor	pos=V,polar=NEG,mood=IND,inter=DECL,tense=PRS,per=1,num=PL,aspect=PROG	değiştirmiyoruz
değiştirmiyorsunuz	pos=V,polar=POS,mood=IND,inter=DECL,tense=PRS,per=2,num=SG,aspect={IPFV/PFV}	değiştirirsin
delerim	pos=V,polar=NEG,mood=IND,inter=DECL,tense=PRS,per=3,num=PL,aspect=PROG	delmiyorlar
delersin	pos=V,polar=POS,mood=IND,inter=DECL,tense=PRS,per=2,num=SG,aspect=PROG	deliyorsun
delimi	pos=N,tense=PRS,per=3,num=PL,aspect={IPFV/PFV}	delilerdir
deliririm	pos=V,polar=POS,mood=IND,inter=DECL,tense=PRS,per=3,num=PL,aspect=PROG	deliriyorlar
deliriyordum	pos=V,polar=NEG,mood=IND,inter=DECL,tense=PRS,per=1,num=SG,aspect={IPFV/PFV}	delirmem
delirmedi	pos=V,polar=NEG,mood=IND,inter=DECL,tense=PRS,per=2,num=SG,aspect={IPFV/PFV}	delirmezsin
delirmem	pos=V,polar=POS,mood=IND,inter=DECL,tense=PRS,per=2,num=PL,aspect={IPFV/PFV}	delirirsiniz
delirmiyorlar	pos=V,polar=POS,mood=IND,inter=DECL,tense=PRS,per=2,num=SG,aspect={IPFV/PFV}	delirirsin
delmiyordular	pos=V,polar=POS,mood=IND,inter=DECL,tense=PRS,per=3,num=SG,aspect=PROG	deliyor
delmiyordunuz	pos=V,polar=NEG,mood=IND,inter=DECL,tense=PRS,per=1,num=PL,aspect={IPFV/PFV}	delmeyiz
demirciye	pos=N,tense=PRS,per=2,num=SG,aspect={IPFV/PFV}	demircisiniz
demlemezsin	pos=V,polar=NEG,mood=IND,inter=DECL,tense=PRS,per=3,num=SG,aspect=PROG	demlemiyor
demlemiyordu	pos=V,polar=POS,mood=IND,inter=DECL,tense=PRS,per=2,num=SG,aspect=PROG	demliyorsun
demliyorlardı	pos=V,polar=POS,mood=IND,inter=DECL,tense=PRS,per=1,num=PL,aspect=PROG	demliyoruz
demliyorsun	pos=V,polar=NEG,mood=IND,inter=DECL,tense=PRS,per=3,num=SG,aspect={IPFV/PFV}	demlemez
denildim	pos=V,polar=NEG,mood=IND,inter=DECL,tense=PST,per=3,num=PL,aspect=PFV	denilmediler
denilmedi	pos=V,polar=POS,mood=IND,inter=DECL,tense=PRS,per=3,num=PL,aspect={IPFV/PFV}	denilirler
denilmeyeceksin	pos=V,polar=NEG,mood=IND,inter=DECL,tense=PRS,per=1,num=PL,aspect=PROG	denilmiyoruz
derneklerine	pos=N,tense=PRS,per=2,num=SG,aspect={IPFV/PFV}	derneksiniz
dinozorumuzdan	pos=N,tense=PRS,per=3,num=PL,aspect={IPFV/PFV}	dinozorlardır
diriliyorduk	pos=V,polar=NEG,mood=IND,inter=DECL,tense=PST,per=2,num=PL,aspect={IPFV/PROG}	dirilmiyordunuz
dirilmeiyordum	pos=V,polar=POS,mood=IND,inter=DECL,tense=PRS,per=1,num=SG,aspect={IPFV/PFV}	dirilmezim
dirilmemeyecekler	pos=V,polar=POS,mood=IND,inter=DECL,tense=PRS,per=2,num=PL,aspect={IPFV/PFV}	dirilmezsiniz
dirilmiyorduk	pos=V,polar=NEG,mood=IND,inter=DECL,tense=PRS,per=3,num=PL,aspect=PROG	dirilmiyorlar
dirilmiyordum	pos=V,polar=POS,mood=IND,inter=DECL,tense=PST,per=2,num=PL,aspect=PFV	dirildiniz
dizeceğim	pos=V,polar=POS,mood=IND,inter=DECL,tense=PST,per=2,num=SG,aspect={IPFV/PROG}	diziyordun
diziyorsun	pos=V,polar=POS,mood=IND,inter=DECL,tense=PRS,per=1,num=PL,aspect=PROG	diziyoruz
doğacaksın	pos=V,polar=POS,mood=IND,inter=DECL,tense=PST,per=2,num=PL,aspect=PFV	doğdunuz
doğmadım	pos=V,polar=NEG,mood=IND,inter=DECL,tense=PST,per=3,num=SG,aspect={IPFV/PROG}	doğmuyordu
doğramadılar	pos=V,polar=POS,mood=IND,inter=DECL,tense=PRS,per=2,num=PL,aspect={IPFV/PFV}	doğrarsınız
doğramıyoruz	pos=V,polar=NEG,mood=IND,inter=DECL,tense=PRS,per=2,num=SG,aspect={IPFV/PFV}	doğramazsın
doğrayacağım	pos=V,polar=POS,mood=IND,inter=DECL,tense=PRS,per=3,num=SG,aspect={IPFV/PFV}	doğrar
doğruyor	pos=V,polar=NEG,mood=IND,inter=DECL,tense=PRS,per=1,num=PL,aspect={IPFV/PFV}	doğramayız
doğurdular	pos=V,polar=NEG,mood=IND,inter=DECL,tense=PST,per=2,num=PL,aspect={IPFV/PROG}	doğurmuyordunuz
doğuyorum	pos=V,polar=POS,mood=IND,inter=DECL,tense=PRS,per=1,num=SG,aspect={IPFV/PFV}	doğarım
dökmüyorum	pos=V,polar=POS,mood=IND,inter=DECL,tense=PRS,per=2,num=PL,aspect={IPFV/PFV}	dökersiniz
doktoruma	pos=N,tense=PRS,per=1,num=PL,aspect={IPFV/PFV}	doktorlarız
döktük	pos=V,polar=POS,mood=IND,inter=DECL,tense=PST,per=3,num=PL,aspect={IPFV/PROG}	döküyorlardı
dokunmayacak	pos=V,polar=POS,mood=IND,inter=DECL,tense=PRS,per=1,num=SG,aspect={IPFV/PFV}	dokunurum
dokunmayacaksın	pos=V,polar=NEG,mood=IND,inter=DECL,tense=PST,per=2,num=PL,aspect={IPFV/PROG}	dokunmuyordunuz
dokunmuyordular	pos=V,polar=NEG,mood=IND,inter=DECL,tense=PST,per=3,num=PL,aspect=PFV	dokunmadılar
döndüm	pos=V,polar=NEG,mood=IND,inter=DECL,tense=PRS,per=2,num=PL,aspect=PROG	dönmüyorsunuz
döndürdüm	pos=V,polar=POS,mood=IND,inter=DECL,tense=PRS,per=1,num=PL,aspect={IPFV/PFV}	döndürüriz
dondurdu	pos=V,polar=NEG,mood=IND,inter=DECL,tense=PRS,per=1,num=SG,aspect=PROG	dondurmuyorum
dondurdu	pos=V,polar=POS,mood=IND,inter=DECL,tense=PRS,per=1,num=SG,aspect=PROG	donduruyorum
dondurmazsın	pos=V,polar=NEG,mood=IND,inter=DECL,tense=PRS,per=3,num=PL,aspect={IPFV/PFV}	dondurmazlar
döndürmedi	pos=V,polar=NEG,mood=IND,inter=DECL,tense=PRS,per=1,num=PL,aspect={IPFV/PFV}	döndürmeyiz
dondururum	pos=V,polar=POS,mood=IND,inter=DECL,tense=PST,per=2,num=PL,aspect=PFV	dondurdunuz
donduruyordum	pos=V,polar=POS,mood=IND,inter=DECL,tense=PST,per=1,num=PL,aspect=PFV	dondurduk
döndürüyordum	pos=V,polar=POS,mood=IND,inter=DECL,tense=PST,per=3,num=SG,aspect=PFV	döndürdü
döndürüyordunuz	pos=V,polar=NEG,mood=IND,inter=DECL,tense=PRS,per=1,num=PL,aspect={IPFV/PFV}	döndürmeyiz
döndürüyordu	pos=V,polar=NEG,mood=IND,inter=DECL,tense=PRS,per=1,num=PL,aspect={IPFV/PFV}	döndürmeyiz
döndürüyorsunuz	pos=V,polar=NEG,mood=IND,inter=DECL,tense=PRS,per=3,num=PL,aspect={IPFV/PFV}	döndürmezler
dönecek	pos=V,polar=POS,mood=IND,inter=DECL,tense=PST,per=3,num=PL,aspect={IPFV/PROG}	dönüyorlardı
döneceksin	pos=V,polar=POS,mood=IND,inter=DECL,tense=PRS,per=1,num=SG,aspect={IPFV/PFV}	dönerim
dönmeyecekler	pos=V,polar=NEG,mood=IND,inter=DECL,tense=PRS,per=1,num=PL,aspect={IPFV/PFV}	dönmeyiz
dönmüyordum	pos=V,polar=POS,mood=IND,inter=DECL,tense=PRS,per=1,num=SG,aspect=PROG	dönüyorum
donuyorlardı	pos=V,polar=POS,mood=IND,inter=DECL,tense=PRS,per=1,num=SG,aspect=PROG	donuyorum
donuyorum	pos=V,polar=POS,mood=IND,inter=DECL,tense=PRS,per=2,num=SG,aspect={IPFV/PFV}	donarsın
donuyoruz	pos=V,polar=NEG,mood=IND,inter=DECL,tense=PRS,per=3,num=SG,aspect=PROG	donmuyor
doyarım	pos=V,polar=NEG,mood=IND,inter=DECL,tense=PRS,per=2,num=SG,aspect=PROG	doymuyorsun
doymadım	pos=V,polar=NEG,mood=IND,inter=DECL,tense=PRS,per=1,num=PL,aspect=PROG	doymuyoruz
doymadı	pos=V,polar=NEG,mood=IND,inter=DECL,tense=PST,per=3,num=PL,aspect={IPFV/PROG}	doymuyordular
doymayız	pos=V,polar=NEG,mood=IND,inter=DECL,tense=PST,per=3,num=SG,aspect={IPFV/PROG}	doymuyordu
doymayız	pos=V,polar=POS,mood=IND,inter=DECL,tense=PST,per=1,num=SG,aspect=PFV	doydum
doymazsınız	pos=V,polar=POS,mood=IND,inter=DECL,tense=PST,per=1,num=SG,aspect=PFV	doydum
doymazsın	pos=V,polar=NEG,mood=IND,inter=DECL,tense=PRS,per=1,num=SG,aspect={IPFV/PFV}	doymam
doymuyordu	pos=V,polar=NEG,mood=IND,inter=DECL,tense=PRS,per=1,num=SG,aspect=PROG	doymuyorum
doyuyordu	pos=V,polar=NEG,mood=IND,inter=DECL,tense=PRS,per=2,num=SG,aspect=PROG	doymuyorsun
doyuyorsun	pos=V,polar=POS,mood=IND,inter=DECL,tense=PST,per=1,num=PL,aspect={IPFV/PROG}	doyuyorduk
doyuyorum	pos=V,polar=NEG,mood=IND,inter=DECL,tense=PRS,per=3,num=SG,aspect={IPFV/PFV}	doymaz
dublörlerimizi	pos=N,tense=PRS,per=1,num=SG,aspect={IPFV/PFV}	dublörüz
durmaz	pos=V,polar=POS,mood=IND,inter=DECL,tense=PST,per=2,num=SG,aspect={IPFV/PROG}	duruyordun
durmazsınız	pos=V,polar=POS,mood=IND,inter=DECL,tense=PST,per=1,num=SG,aspect=PFV	durdum
durmuyordunuz	pos=V,polar=NEG,mood=IND,inter=DECL,tense=PST,per=1,num=SG,aspect={IPFV/PROG}	durmuyordum
düşmanınız	pos=N,tense=PRS,per=1,num=SG,aspect={IPFV/PFV}	düşmanız
düşmanlarınızı	pos=N,tense=PRS,per=2,num=SG,aspect={IPFV/PFV}	düşmansınız
düştük	pos=V,polar=NEG,mood=IND,inter=DECL,tense=PST,per=3,num=SG,aspect={IPFV/PROG}	düşmüyordu
düştün	pos=V,polar=NEG,mood=IND,inter=DECL,tense=PST,per=1,num=PL,aspect=PFV	düşmedik
düşünecekler	pos=V,polar=NEG,mood=IND,inter=DECL,tense=PRS,per=3,num=SG,aspect=PROG	düşünmüyor
düşünmeyiz	pos=V,polar=NEG,mood=IND,inter=DECL,tense=PRS,per=2,num=PL,aspect=PROG	düşünmüyorsunuz
düşünüyoruz	pos=V,polar=NEG,mood=IND,inter=DECL,tense=PRS,per=3,num=PL,aspect=PROG	düşünmüyorlar
düşüyordu	pos=V,polar=POS,mood=IND,inter=DECL,tense=PRS,per=3,num=PL,aspect={IPFV/PFV}	düşerler
duymuyor	pos=V,polar=NEG,mood=IND,inter=DECL,tense=PRS,per=1,num=PL,aspect=PROG	duymuyoruz
duyuyorsun	pos=V,polar=NEG,mood=IND,inter=DECL,tense=PRS,per=1,num=PL,aspect={IPFV/PFV}	duymayız
düzdük	pos=V,polar=NEG,mood=IND,inter=DECL,tense=PST,per=2,num=PL,aspect=PFV	düzmediniz
düzeceğiz	pos=V,polar=NEG,mood=IND,inter=DECL,tense=PRS,per=3,num=SG,aspect=PROG	düzmüyor
düzeceğiz	pos=V,polar=POS,mood=IND,inter=DECL,tense=PRS,per=2,num=SG,aspect=PROG	düzüyorsun
düzeceğiz	pos=V,polar=POS,mood=IND,inter=DECL,tense=PST,per=1,num=SG,aspect=PFV	düzdüm
düzeleceksiniz	pos=V,polar=POS,mood=IND,inter=DECL,tense=PRS,per=3,num=PL,aspect={IPFV/PFV}	düzeltirler
düzeleceksin	pos=V,polar=NEG,mood=IND,inter=DECL,tense=PRS,per=2,num=SG,aspect={IPFV/PFV}	düzelmezsin
düzeliyordun	pos=V,polar=NEG,mood=IND,inter=DECL,tense=PRS,per=2,num=SG,aspect={IPFV/PFV}	düzelmezsin
düzelmeyecekler	pos=V,polar=NEG,mood=IND,inter=DECL,tense=PST,per=1,num=PL,aspect=PFV	düzelmedik
düzelmiyordum	pos=V,polar=POS,mood=IND,inter=DECL,tense=PRS,per=3,num=PL,aspect={IPFV/PFV}	düzeltirler
düzelmiyorum	pos=V,polar=NEG,mood=IND,inter=DECL,tense=PRS,per=2,num=SG,aspect={IPFV/PFV}	düzelmezsin
düzeriz	pos=V,polar=NEG,mood=IND,inter=DECL,tense=PRS,per=2,num=SG,aspect=PROG	düzmüyorsun
düzmüyordum	pos=V,polar=NEG,mood=IND,inter=DECL,tense=PST,per=2,num=PL,aspect={IPFV/PROG}	düzmüyordunuz
düzmüyordu	pos=V,polar=POS,mood=IND,inter=DECL,tense=PRS,per=1,num=PL,aspect=PROG	düzüyoruz
düzmüyorsunuz	pos=V,polar=POS,mood=IND,inter=DECL,tense=PST,per=2,num=PL,aspect={IPFV/PROG}	düzüyordunuz
düzüyordun	pos=V,polar=POS,mood=IND,inter=DECL,tense=PRS,per=3,num=PL,aspect={IPFV/PFV}	düzerler
düzüyorlar	pos=V,polar=NEG,mood=IND,inter=DECL,tense=PRS,per=2,num=PL,aspect={IPFV/PFV}	düzmezsiniz
ecenizi	pos=N,tense=PRS,per=3,num=PL,aspect={IPFV/PFV}	ecelerdir
eceye	pos=N,tense=PRS,per=3,num=PL,aspect={IPFV/PFV}	ecelerdir
ediyorlar	pos=V,tense=PRS,per=1,num=PL,aspect=PROG	ediyoruz
ediyoruz	pos=V,tense=PRS,per=1,num=SG,aspect=PROG	ediyorum
ediyoruz	pos=V,tense=PRS,per=3,num=SG,aspect=PROG	ediyor
efelerimizde	pos=N,tense=PRS,per=1,num=SG,aspect={IPFV/PFV}	efeyiz
efemizden	pos=N,tense=PRS,per=3,num=PL,aspect={IPFV/PFV}	efelerdir
eğildi	pos=V,polar=POS,mood=IND,inter=DECL,tense=PST,per=3,num=PL,aspect=PFV	eğildiler
eğilmedi	pos=V,polar=NEG,mood=IND,inter=DECL,tense=PST,per=1,num=SG,aspect={IPFV/PROG}	eğilmiyordum
eğilmiyordum	pos=V,polar=NEG,mood=IND,inter=DECL,tense=PRS,per=3,num=PL,aspect={IPFV/PFV}	eğilmezler
eğitiyorum	pos=V,polar=NEG,mood=IND,inter=DECL,tense=PRS,per=3,num=SG,aspect={IPFV/PFV}	eğitmez
eğitmedim	pos=V,polar=NEG,mood=IND,inter=DECL,tense=PRS,per=3,num=PL,aspect=PROG	eğitmiyorlar
eğitmeyecekler	pos=V,polar=NEG,mood=IND,inter=DECL,tense=PST,per=3,num=PL,aspect=PFV	eğitmediler
eğitmeyiz	pos=V,polar=POS,mood=IND,inter=DECL,tense=PRS,per=1,num=SG,aspect={IPFV/PFV}	eğitirim
eğittiniz	pos=V,polar=NEG,mood=IND,inter=DECL,tense=PST,per=2,num=PL,aspect={IPFV/PROG}	eğitmiyordunuz
eğlenmem	pos=V,polar=NEG,mood=IND,inter=DECL,tense=PST,per=1,num=SG,aspect=PFV	eğlenmedim
eğlenmeyeceğim	pos=V,polar=NEG,mood=IND,inter=DECL,tense=PRS,per=3,num=SG,aspect={IPFV/PFV}	eğlenmez
eğlenmiyordun	pos=V,polar=NEG,mood=IND,inter=DECL,tense=PST,per=2,num=SG,aspect=PFV	eğlenmedin
eğlenmiyorum	pos=V,polar=NEG,mood=IND,inter=DECL,tense=PRS,per=1,num=PL,aspect=PROG	eğlenmiyoruz
eklersiniz	pos=N,tense=PRS,per=3,num=SG,aspect={IPFV/PFV}	ekler
ekşiteceğiz	pos=V,polar=POS,mood=IND,inter=DECL,tense=PRS,per=1,num=SG,aspect=PROG	ekşitiyorum
ekşiteceksiniz	pos=V,polar=NEG,mood=IND,inter=DECL,tense=PRS,per=3,num=SG,aspect=PROG	ekşitmiyor
ekşitiyordum	pos=V,polar=NEG,mood=IND,inter=DECL,tense=PST,per=3,num=PL,aspect={IPFV/PROG}	ekşitmiyordular
ekşitmedik	pos=V,polar=POS,mood=IND,inter=DECL,tense=PST,per=2,num=PL,aspect=PFV	ekşittiniz
ekşitmediler	pos=V,polar=NEG,mood=IND,inter=DECL,tense=PST,per=1,num=PL,aspect={IPFV/PROG}	ekşitmiyorduk
ekşitmediniz	pos=V,polar=NEG,mood=IND,inter=DECL,tense=PST,per=3,num=PL,aspect={IPFV/PROG}	ekşitmiyordular
ekşitmeyeceğim	pos=V,polar=POS,mood=IND,inter=DECL,tense=PRS,per=3,num=PL,aspect=PROG	ekşitiyorlar
ekşitmiyorduk	pos=V,polar=POS,mood=IND,inter=DECL,tense=PRS,per=3,num=SG,aspect={IPFV/PFV}	ekşitir
ekşitmiyordular	pos=V,polar=NEG,mood=IND,inter=DECL,tense=PST,per=3,num=SG,aspect={IPFV/PROG}	ekşitmiyordu
ekşitmiyoruz	pos=V,polar=POS,mood=IND,inter=DECL,tense=PST,per=1,num=PL,aspect={IPFV/PROG}	ekşitiyorduk
elledi	pos=V,polar=NEG,mood=IND,inter=DECL,tense=PRS,per=2,num=PL,aspect=PROG	ellemiyorsunuz
ellemiyordunuz	pos=V,polar=NEG,mood=IND,inter=DECL,tense=PRS,per=1,num=PL,aspect=PROG	ellemiyoruz
elliyorlar	pos=V,polar=POS,mood=IND,inter=DECL,tense=PST,per=1,num=SG,aspect=PFV	elledim
emeceğim	pos=V,polar=NEG,mood=IND,inter=DECL,tense=PRS,per=3,num=SG,aspect={IPFV/PFV}	emmez
emiyordun	pos=V,polar=NEG,mood=IND,inter=DECL,tense=PST,per=3,num=SG,aspect=PFV	emmedi
emmedi	pos=V,polar=NEG,mood=IND,inter=DECL,tense=PRS,per=3,num=PL,aspect=PROG	emmiyorlar
emmem	pos=V,polar=NEG,mood=IND,inter=DECL,tense=PST,per=2,num=PL,aspect=PFV	emmediniz
emmilerimi	pos=N,tense=PRS,per=1,num=SG,aspect={IPFV/PFV}	emmiyiz
eniştesi	pos=N,tense=PRS,per=3,num=SG,aspect={IPFV/PFV}	enişteler
enişteyi	pos=N,tense=PRS,per=2,num=PL,aspect={IPFV/PFV}	eniştelersiniz
erkecellerim	pos=N,tense=PRS,per=2,num=PL,aspect={IPFV/PFV}	erkecellersiniz
erkeneğine	pos=N,tense=PRS,per=3,num=SG,aspect={IPFV/PFV}	erkenekler
eşcinsellerimde	pos=N,tense=PRS,per=3,num=SG,aspect={IPFV/PFV}	eşcinseller
eşcinselleriniz	pos=N,tense=PRS,per=1,num=SG,aspect={IPFV/PFV}	eşcinseliz
eşyanızdan	pos=N,tense=PRS,per=2,num=SG,aspect={IPFV/PFV}	eşyasınız
etkiledim	pos=V,polar=NEG,mood=IND,inter=DECL,tense=PST,per=1,num=SG,aspect={IPFV/PROG}	etkilemiyordum
etkiliyorlar	pos=V,polar=POS,mood=IND,inter=DECL,tense=PST,per=3,num=SG,aspect={IPFV/PROG}	etkiliyordu
etkiliyoruz	pos=V,polar=POS,mood=IND,inter=DECL,tense=PRS,per=1,num=PL,aspect={IPFV/PFV}	etkileriz
etmedim	pos=V,tense=PRS,per=2,num=PL,aspect={IPFV/PFV}	etmezsiniz
etmem	pos=V,tense=PST,per=1,num=PL,aspect={IPFV/PROG}	etmiyorduk
ettirdin	pos=V,polar=POS,mood=IND,inter=DECL,tense=PRS,per=1,num=SG,aspect={IPFV/PFV}	ettiririm
ettirmedim	pos=V,polar=POS,mood=IND,inter=DECL,tense=PRS,per=1,num=SG,aspect={IPFV/PFV}	ettiririm
ettirmeyecek	pos=V,polar=POS,mood=IND,inter=DECL,tense=PST,per=1,num=PL,aspect=PFV	ettirdik
ettirmiyorsun	pos=V,polar=POS,mood=IND,inter=DECL,tense=PST,per=1,num=PL,aspect={IPFV/PROG}	ettiriyorduk
ettirtiyorsunuz	pos=V,polar=NEG,mood=IND,inter=DECL,tense=PRS,per=1,num=PL,aspect={IPFV/PFV}	ettirtmeyiz
ettirtmiyorsunuz	pos=V,polar=POS,mood=IND,inter=DECL,tense=PST,per=3,num=SG,aspect={IPFV/PROG}	ettirtiyordu
ezberledik	pos=V,tense=PST,per=3,num=SG,aspect={IPFV/PROG}	ezberliyordu
ezberler	pos=V,tense=PRS,per=1,num=SG,aspect={IPFV/PFV}	ezberlerim
ezberlersiniz	pos=V,tense=PRS,per=2,num=SG,aspect={IPFV/PFV}	ezberlersin
ezberliyor	pos=V,tense=PRS,per=1,num=PL,aspect={IPFV/PFV}	ezberleriz
eziyetçiydiler	pos=N,tense=PRS,per=1,num=SG,aspect={IPFV/PFV}	eziyetçiyiz
fakirleştirdin	pos=V,polar=POS,mood=IND,inter=DECL,tense=PRS,per=3,num=PL,aspect=PROG	fakirleştiriyorlar
fakirleştirdin	pos=V,polar=POS,mood=IND,inter=DECL,tense=PST,per=1,num=PL,aspect=PFV	fakirleştirdik
fakirleştirdi	pos=V,polar=POS,mood=IND,inter=DECL,tense=PRS,per=3,num=PL,aspect={IPFV/PFV}	fakirleştirirler
fakirleştireceğim	pos=V,polar=NEG,mood=IND,inter=DECL,tense=PRS,per=2,num=SG,aspect=PROG	fakirleştirmiyorsun
fakirleştiriyoruz	pos=V,polar=NEG,mood=IND,inter=DECL,tense=PRS,per=1,num=PL,aspect={IPFV/PFV}	fakirleştirmeyiz
fakirleştirmedim	pos=V,polar=NEG,mood=IND,inter=DECL,tense=PST,per=3,num=SG,aspect={IPFV/PROG}	fakirleştirmiyordu
fakirleştirmeyeceksin	pos=V,polar=POS,mood=IND,inter=DECL,tense=PST,per=3,num=SG,aspect=PFV	fakirleştirdi
fakirleştirmiyordunuz	pos=V,polar=NEG,mood=IND,inter=DECL,tense=PRS,per=2,num=SG,aspect={IPFV/PFV}	fakirleştirmezsin
fasıklara	pos=N,tense=PRS,per=3,num=SG,aspect={IPFV/PFV}	fasıklar
flaşlarsınız	pos=N,tense=PRS,per=3,num=PL,aspect={IPFV/PFV}	flaşlardır
fortlamadınız	pos=V,polar=POS,mood=IND,inter=DECL,tense=PRS,per=2,num=SG,aspect={IPFV/PFV}	fortlarsın
fortlıyordu	pos=V,polar=POS,mood=IND,inter=DECL,tense=PRS,per=2,num=PL,aspect={IPFV/PFV}	fortlarsınız
fortlıyoruz	pos=V,polar=POS,mood=IND,inter=DECL,tense=PRS,per=3,num=SG,aspect=PROG	fortlıyor
futbolculardı	pos=N,tense=PRS,per=3,num=PL,aspect={IPFV/PFV}	futbolculardır
geberirsiniz	pos=V,polar=NEG,mood=IND,inter=DECL,tense=PST,per=2,num=SG,aspect=PFV	gebermedin
geberiyordu	pos=V,polar=NEG,mood=IND,inter=DECL,tense=PST,per=2,num=PL,aspect={IPFV/PROG}	gebermiyordunuz
geberiyorsun	pos=V,polar=POS,mood=IND,inter=DECL,tense=PST,per=3,num=PL,aspect={IPFV/PROG}	geberiyorlardı
gebermiyorduk	pos=V,polar=POS,mood=IND,inter=DECL,tense=PST,per=2,num=PL,aspect={IPFV/PROG}	geberiyordunuz
gebermiyordunuz	pos=V,polar=NEG,mood=IND,inter=DECL,tense=PST,per=1,num=PL,aspect={IPFV/PROG}	gebermiyorduk
gebermiyorsunuz	pos=V,polar=NEG,mood=IND,inter=DECL,tense=PST,per=1,num=SG,aspect={IPFV/PROG}	gebermiyordum
geçeceksiniz	pos=V,polar=NEG,mood=IND,inter=DECL,tense=PST,per=3,num=PL,aspect={IPFV/PROG}	geçmiyordular
gecikeceğim	pos=V,polar=NEG,mood=IND,inter=DECL,tense=PST,per=3,num=PL,aspect={IPFV/PROG}	gecikmiyordular
gecikirim	pos=V,polar=NEG,mood=IND,inter=DECL,tense=PRS,per=3,num=PL,aspect={IPFV/PFV}	gecikmezler
gecikmeyeceksiniz	pos=V,polar=NEG,mood=IND,inter=DECL,tense=PST,per=3,num=SG,aspect={IPFV/PROG}	gecikmiyordu
geciktireceğiz	pos=V,polar=NEG,mood=IND,inter=DECL,tense=PRS,per=3,num=SG,aspect=PROG	geciktirmiyor
geciktiriyordum	pos=V,polar=NEG,mood=IND,inter=DECL,tense=PRS,per=3,num=SG,aspect={IPFV/PFV}	geciktirmez
geciktirmiyordu	pos=V,polar=NEG,mood=IND,inter=DECL,tense=PRS,per=3,num=SG,aspect=PROG	geciktirmiyor
geciktirmiyorum	pos=V,polar=POS,mood=IND,inter=DECL,tense=PRS,per=1,num=SG,aspect={IPFV/PFV}	geciktiririm
geciktirmiyorum	pos=V,polar=POS,mood=IND,inter=DECL,tense=PST,per=1,num=SG,aspect=PFV	geciktirtim
geciktirtmedim	pos=V,polar=POS,mood=IND,inter=DECL,tense=PRS,per=1,num=PL,aspect=PROG	geciktirtiyoruz
geciktirtmezler	pos=V,polar=NEG,mood=IND,inter=DECL,tense=PRS,per=2,num=SG,aspect={IPFV/PFV}	geciktirtmezsin
geciktirtmiyorduk	pos=V,polar=NEG,mood=IND,inter=DECL,tense=PST,per=3,num=SG,aspect={IPFV/PROG}	geciktirtmiyordu
geçinecekler	pos=V,polar=NEG,mood=IND,inter=DECL,tense=PST,per=1,num=SG,aspect={IPFV/PROG}	geçinmiyordum
geçiniyordum	pos=V,polar=NEG,mood=IND,inter=DECL,tense=PRS,per=3,num=SG,aspect=PROG	geçinmiyor
geçinmiyordun	pos=V,polar=POS,mood=IND,inter=DECL,tense=PRS,per=1,num=SG,aspect={IPFV/PFV}	geçinirim
geçinmiyor	pos=V,polar=NEG,mood=IND,inter=DECL,tense=PST,per=1,num=SG,aspect={IPFV/PROG}	geçinmiyordum
geçiyordu	pos=V,polar=POS,mood=IND,inter=DECL,tense=PST,per=3,num=PL,aspect=PFV	geçtiler
geçmeyecek	pos=V,polar=POS,mood=IND,inter=DECL,tense=PRS,per=3,num=PL,aspect={IPFV/PFV}	geçerler
geğirdin	pos=V,polar=POS,mood=IND,inter=DECL,tense=PST,per=1,num=SG,aspect={IPFV/PROG}	geğiriyordum
geğireceğiz	pos=V,polar=NEG,mood=IND,inter=DECL,tense=PRS,per=1,num=SG,aspect={IPFV/PFV}	geğirmem
geğirmiyordun	pos=V,polar=POS,mood=IND,inter=DECL,tense=PST,per=3,num=PL,aspect=PFV	geğirdiler
gelineceksin	pos=V,polar=POS,mood=IND,inter=DECL,tense=PST,per=2,num=SG,aspect=PFV	gelindin
geliniyoruz	pos=V,polar=NEG,mood=IND,inter=DECL,tense=PRS,per=2,num=SG,aspect={IPFV/PFV}	gelinmezsin
gelinmedin	pos=V,polar=NEG,mood=IND,inter=DECL,tense=PRS,per=2,num=PL,aspect={IPFV/PFV}	gelinmezsiniz
gelinmiyordunuz	pos=V,polar=POS,mood=IND,inter=DECL,tense=PRS,per=2,num=PL,aspect=PROG	geliniyorsunuz
gelinmiyorum	pos=V,polar=NEG,mood=IND,inter=DECL,tense=PST,per=1,num=PL,aspect={IPFV/PROG}	gelinmiyorduk
gelişirler	pos=V,polar=POS,mood=IND,inter=DECL,tense=PST,per=3,num=PL,aspect=PFV	geliştiler
gelişiyorsunuz	pos=V,polar=POS,mood=IND,inter=DECL,tense=PRS,per=2,num=PL,aspect={IPFV/PFV}	gelişirsiniz
geliştirirsin	pos=V,polar=NEG,mood=IND,inter=DECL,tense=PRS,per=2,num=SG,aspect=PROG	geliştirmiyorsun
geliştiriyordun	pos=V,polar=POS,mood=IND,inter=DECL,tense=PST,per=3,num=SG,aspect=PFV	geliştirdi
geliştirmiyordum	pos=V,polar=POS,mood=IND,inter=DECL,tense=PRS,per=1,num=PL,aspect=PROG	geliştiriyoruz
geliştirmiyordu	pos=V,polar=NEG,mood=IND,inter=DECL,tense=PST,per=2,num=SG,aspect={IPFV/PROG}	geliştirmiyordun
geliştirmiyordu	pos=V,polar=NEG,mood=IND,inter=DECL,tense=PST,per=3,num=PL,aspect=PFV	geliştirmediler
geliyordunuz	pos=V,polar=NEG,mood=IND,inter=DECL,tense=PST,per=3,num=SG,aspect=PFV	gelmedi
geliyorsun	pos=V,polar=NEG,mood=IND,inter=DECL,tense=PST,per=3,num=SG,aspect=PFV	gelmedi
gelmedim	pos=V,polar=POS,mood=IND,inter=DECL,tense=PRS,per=3,num=PL,aspect={IPFV/PFV}	gelirler
gelmezler	pos=V,polar=POS,mood=IND,inter=DECL,tense=PST,per=3,num=PL,aspect={IPFV/PROG}	geliyorlardı
gelmiyor	pos=V,polar=POS,mood=IND,inter=DECL,tense=PST,per=3,num=SG,aspect=PFV	geldi
gerindin	pos=V,polar=NEG,mood=IND,inter=DECL,tense=PST,per=2,num=SG,aspect=PFV	gerinmedin
geriniyordunuz	pos=V,polar=NEG,mood=IND,inter=DECL,tense=PST,per=1,num=PL,aspect=PFV	gerinmedik
geriniyorlar	pos=V,polar=NEG,mood=IND,inter=DECL,tense=PST,per=1,num=SG,aspect={IPFV/PROG}	gerinmiyordum
geriniyorlar	pos=V,polar=NEG,mood=IND,inter=DECL,tense=PST,per=2,num=PL,aspect={IPFV/PROG}	gerinmiyordunuz
geriniyorlar	pos=V,polar=POS,mood=IND,inter=DECL,tense=PST,per=3,num=SG,aspect={IPFV/PROG}	geriniyordu
gerinmedin	pos=V,polar=POS,mood=IND,inter=DECL,tense=PST,per=1,num=SG,aspect=PFV	gerindim
gerinmeyecekler	pos=V,polar=NEG,mood=IND,inter=DECL,tense=PST,per=2,num=PL,aspect={IPFV/PROG}	gerinmiyordunuz
gerinmez	pos=V,polar=POS,mood=IND,inter=DECL,tense=PST,per=3,num=SG,aspect={IPFV/PROG}	geriniyordu
gerinmiyordun	pos=V,polar=NEG,mood=IND,inter=DECL,tense=PRS,per=3,num=SG,aspect=PROG	gerinmiyor
gerzeklerdi	pos=N,tense=PRS,per=3,num=SG,aspect={IPFV/PFV}	gerzekler
getiriyordu	pos=V,polar=POS,mood=IND,inter=DECL,tense=PRS,per=3,num=PL,aspect=PROG	getiriyorlar
getirmediniz	pos=V,polar=NEG,mood=IND,inter=DECL,tense=PRS,per=3,num=PL,aspect=PROG	getirmiyorlar
getirmeyecekler	pos=V,polar=POS,mood=IND,inter=DECL,tense=PST,per=2,num=SG,aspect={IPFV/PROG}	getiriyordun
getirmeyiz	pos=V,polar=POS,mood=IND,inter=DECL,tense=PST,per=3,num=PL,aspect=PFV	getirdiler
getirmiyorlar	pos=V,polar=POS,mood=IND,inter=DECL,tense=PRS,per=2,num=PL,aspect={IPFV/PFV}	getirirsiniz
gezeceksiniz	pos=V,polar=NEG,mood=IND,inter=DECL,tense=PRS,per=1,num=SG,aspect=PROG	gezmiyorum
gezeceksin	pos=V,polar=POS,mood=IND,inter=DECL,tense=PST,per=2,num=PL,aspect=PFV	gezdiniz
gezer	pos=V,polar=POS,mood=IND,inter=DECL,tense=PRS,per=1,num=SG,aspect=PROG	geziyorum
geziyorlardı	pos=V,polar=NEG,mood=IND,inter=DECL,tense=PST,per=1,num=SG,aspect=PFV	gezmedim
geziyorsun	pos=V,polar=NEG,mood=IND,inter=DECL,tense=PST,per=1,num=PL,aspect=PFV	gezmedik
gezmiyordum	pos=V,polar=POS,mood=IND,inter=DECL,tense=PST,per=3,num=PL,aspect=PFV	gezdiler
gezmiyorlar	pos=V,polar=POS,mood=IND,inter=DECL,tense=PRS,per=1,num=PL,aspect={IPFV/PFV}	gezeriz
gezmiyorum	pos=V,polar=POS,mood=IND,inter=DECL,tense=PRS,per=2,num=PL,aspect=PROG	geziyorsunuz
gidiliyorlar	pos=V,polar=NEG,mood=IND,inter=DECL,tense=PST,per=1,num=PL,aspect={IPFV/PROG}	gidilmiyorduk
gidiliyorlar	pos=V,polar=POS,mood=IND,inter=DECL,tense=PRS,per=1,num=PL,aspect=PROG	gidiliyoruz
gidilmeyeceğim	pos=V,polar=NEG,mood=IND,inter=DECL,tense=PRS,per=3,num=SG,aspect=PROG	gidilmiyor
gidilmiyorduk	pos=V,polar=POS,mood=IND,inter=DECL,tense=PST,per=2,num=SG,aspect=PFV	gidildin
gidiyordu	pos=V,tense=PRS,per=1,num=PL,aspect={IPFV/PFV}	gideriz
gidiyorlar	pos=V,tense=PRS,per=2,num=PL,aspect=PROG	gidiyorsunuz
gidiyoruz	pos=V,tense=PST,per=2,num=SG,aspect={IPFV/PROG}	gidiyordun
girdik	pos=V,polar=POS,mood=IND,inter=DECL,tense=PST,per=2,num=SG,aspect=PFV	girdin
gireceksiniz	pos=V,polar=NEG,mood=IND,inter=DECL,tense=PRS,per=2,num=PL,aspect=PROG	girmiyorsunuz
giriyordunuz	pos=V,polar=NEG,mood=IND,inter=DECL,tense=PST,per=2,num=PL,aspect={IPFV/PROG}	girmiyordunuz
giriyorlar	pos=V,polar=NEG,mood=IND,inter=DECL,tense=PRS,per=1,num=SG,aspect={IPFV/PFV}	girmem
giriyorlar	pos=V,polar=NEG,mood=IND,inter=DECL,tense=PRS,per=2,num=SG,aspect=PROG	girmiyorsun
girmedin	pos=V,polar=POS,mood=IND,inter=DECL,tense=PST,per=2,num=SG,aspect={IPFV/PROG}	giriyordun
girmeyeceğim	pos=V,polar=POS,mood=IND,inter=DECL,tense=PRS,per=3,num=PL,aspect={IPFV/PFV}	girerler
gitti	pos=V,tense=PRS,per=2,num=PL,aspect=PROG	gidiyorsunuz
giydiler	pos=V,polar=POS,mood=IND,inter=DECL,tense=PST,per=2,num=SG,aspect={IPFV/PROG}	giyiyordun
giydiniz	pos=V,polar=NEG,mood=IND,inter=DECL,tense=PST,per=1,num=PL,aspect=PFV	giymedik
giyecek	pos=V,polar=POS,mood=IND,inter=DECL,tense=PRS,per=3,num=SG,aspect={IPFV/PFV}	giyer
giyer	pos=V,polar=POS,mood=IND,inter=DECL,tense=PRS,per=1,num=PL,aspect=PROG	giyiyoruz
giymezsin	pos=V,polar=NEG,mood=IND,inter=DECL,tense=PST,per=3,num=PL,aspect={IPFV/PROG}	giymiyordular
gizlenirler	pos=V,polar=NEG,mood=IND,inter=DECL,tense=PRS,per=2,num=PL,aspect=PROG	gizlenmiyorsunuz
gönderdik	pos=V,polar=NEG,mood=IND,inter=DECL,tense=PST,per=3,num=SG,aspect={IPFV/PROG}	göndermiyordu
gönderdiler	pos=V,polar=NEG,mood=IND,inter=DECL,tense=PST,per=1,num=PL,aspect={IPFV/PROG}	göndermiyorduk
göndereceğiz	pos=V,polar=POS,mood=IND,inter=DECL,tense=PRS,per=2,num=SG,aspect={IPFV/PFV}	gönderirsin
gönderiyordu	pos=V,polar=NEG,mood=IND,inter=DECL,tense=PRS,per=3,num=PL,aspect=PROG	göndermiyorlar
göndermeyeceğiz	pos=V,polar=POS,mood=IND,inter=DECL,tense=PRS,per=2,num=PL,aspect=PROG	gönderiyorsunuz
göndermeyecek	pos=V,polar=NEG,mood=IND,inter=DECL,tense=PRS,per=1,num=SG,aspect=PROG	göndermiyorum
göndermeyeceksin	pos=V,polar=POS,mood=IND,inter=DECL,tense=PST,per=3,num=PL,aspect={IPFV/PROG}	gönderiyorlardı
göndermezsiniz	pos=V,polar=POS,mood=IND,inter=DECL,tense=PST,per=3,num=SG,aspect=PFV	gönderdi
göndermiyordunuz	pos=V,polar=NEG,mood=IND,inter=DECL,tense=PST,per=2,num=PL,aspect=PFV	göndermediniz
görmeyecekler	pos=V,polar=NEG,mood=IND,inter=DECL,tense=PST,per=2,num=SG,aspect={IPFV/PROG}	görmüyordun
görmüyorduk	pos=V,polar=POS,mood=IND,inter=DECL,tense=PRS,per=1,num=PL,aspect={IPFV/PFV}	görürüz
gösteririm	pos=V,polar=NEG,mood=IND,inter=DECL,tense=PST,per=3,num=PL,aspect={IPFV/PROG}	göstermiyordular
gösteriyorduk	pos=V,polar=NEG,mood=IND,inter=DECL,tense=PRS,per=3,num=PL,aspect=PROG	göstermiyorlar
gösteriyor	pos=V,polar=POS,mood=IND,inter=DECL,tense=PRS,per=2,num=SG,aspect=PROG	gösteriyorsun
gösteriyorum	pos=V,polar=NEG,mood=IND,inter=DECL,tense=PRS,per=2,num=SG,aspect={IPFV/PFV}	göstermezsin
göstermediniz	pos=V,polar=NEG,mood=IND,inter=DECL,tense=PST,per=3,num=SG,aspect=PFV	göstermedi
göstermeyeceğim	pos=V,polar=NEG,mood=IND,inter=DECL,tense=PRS,per=2,num=SG,aspect=PROG	göstermiyorsun
göstermiyordum	pos=V,polar=NEG,mood=IND,inter=DECL,tense=PST,per=2,num=PL,aspect=PFV	göstermediniz
götümüzde	pos=N,tense=PRS,per=3,num=PL,aspect={IPFV/PFV}	götlerdir
gözlemeyiz	pos=V,polar=NEG,mood=IND,inter=DECL,tense=PRS,per=2,num=PL,aspect={IPFV/PFV}	gözlemezsiniz
gözlemiyordunuz	pos=V,polar=NEG,mood=IND,inter=DECL,tense=PRS,per=1,num=PL,aspect=PROG	gözlemiyoruz
gözleriz	pos=V,polar=POS,mood=IND,inter=DECL,tense=PRS,per=1,num=PL,aspect=PROG	gözlüyoruz
güceneceksin	pos=V,polar=POS,mood=IND,inter=DECL,tense=PRS,per=2,num=SG,aspect=PROG	güceniyorsun
gücenirsiniz	pos=V,polar=POS,mood=IND,inter=DECL,tense=PST,per=1,num=SG,aspect={IPFV/PROG}	güceniyordum
güceniyordunuz	pos=V,polar=POS,mood=IND,inter=DECL,tense=PST,per=3,num=SG,aspect={IPFV/PROG}	güceniyordu
güceniyorsunuz	pos=V,polar=NEG,mood=IND,inter=DECL,tense=PRS,per=1,num=SG,aspect=PROG	gücenmiyorum
güceniyorum	pos=V,polar=POS,mood=IND,inter=DECL,tense=PRS,per=1,num=SG,aspect={IPFV/PFV}	gücenirim
gücenmiyordular	pos=V,polar=POS,mood=IND,inter=DECL,tense=PRS,per=3,num=SG,aspect={IPFV/PFV}	gücenir
güldüler	pos=V,polar=POS,mood=IND,inter=DECL,tense=PRS,per=1,num=PL,aspect=PROG	gülüyoruz
gülecek	pos=V,polar=POS,mood=IND,inter=DECL,tense=PRS,per=3,num=SG,aspect={IPFV/PFV}	güler
gülmeyecekler	pos=V,polar=NEG,mood=IND,inter=DECL,tense=PRS,per=3,num=PL,aspect={IPFV/PFV}	gülmezler
gülünçleşirim	pos=V,polar=NEG,mood=IND,inter=DECL,tense=PST,per=1,num=SG,aspect={IPFV/PROG}	gülünçleşmiyordum
gülünçleşmiyordular	pos=V,polar=NEG,mood=IND,inter=DECL,tense=PST,per=2,num=SG,aspect=PFV	gülünçleşmedin
gülünçleşmiyorlar	pos=V,polar=POS,mood=IND,inter=DECL,tense=PRS,per=2,num=PL,aspect={IPFV/PFV}	gülünçleşirsiniz
gülünçleşmiyor	pos=V,polar=NEG,mood=IND,inter=DECL,tense=PST,per=2,num=SG,aspect={IPFV/PROG}	gülünçleşmiyordun
güzelleştiriyordun	pos=V,polar=NEG,mood=IND,inter=DECL,tense=PRS,per=2,num=SG,aspect=PROG	güzelleştirmiyorsun
güzelleştiriyor	pos=V,polar=NEG,mood=IND,inter=DECL,tense=PST,per=3,num=PL,aspect={IPFV/PROG}	güzelleştirmiyordular
haberleşiyorsunuz	pos=V,polar=NEG,mood=IND,inter=DECL,tense=PST,per=1,num=SG,aspect={IPFV/PROG}	haberleşmiyordum
haberleşiyoruz	pos=V,polar=POS,mood=IND,inter=DECL,tense=PRS,per=1,num=PL,aspect={IPFV/PFV}	haberleşiriz
haberleşmeyecek	pos=V,polar=NEG,mood=IND,inter=DECL,tense=PST,per=1,num=SG,aspect={IPFV/PROG}	haberleşmiyordum
haberleşmeyiz	pos=V,polar=POS,mood=IND,inter=DECL,tense=PST,per=1,num=SG,aspect={IPFV/PROG}	haberleşiyordum
haberleştiler	pos=V,polar=POS,mood=IND,inter=DECL,tense=PRS,per=3,num=PL,aspect=PROG	haberleşiyorlar
hacılarım	pos=N,tense=PRS,per=1,num=SG,aspect={IPFV/PFV}	hacıyız
hastalanacağım	pos=V,polar=NEG,mood=IND,inter=DECL,tense=PST,per=2,num=PL,aspect=PFV	hastalanmadınız
hastalanır	pos=V,polar=NEG,mood=IND,inter=DECL,tense=PRS,per=3,num=SG,aspect=PROG	hastalanmıyor
hastalanmadılar	pos=V,polar=NEG,mood=IND,inter=DECL,tense=PRS,per=1,num=PL,aspect=PROG	hastalanmıyoruz
hastalanmıyordu	pos=V,polar=NEG,mood=IND,inter=DECL,tense=PST,per=3,num=PL,aspect=PFV	hastalanmadılar
hastalanmıyorlar	pos=V,polar=POS,mood=IND,inter=DECL,tense=PRS,per=1,num=SG,aspect=PROG	hastalanıyorum
hastalanmıyorsun	pos=V,polar=NEG,mood=IND,inter=DECL,tense=PST,per=3,num=PL,aspect=PFV	hastalanmadılar
heyecanlanacaklar	pos=V,polar=POS,mood=IND,inter=DECL,tense=PST,per=1,num=SG,aspect=PFV	heyecanlandım
heyecanlandırdı	pos=V,polar=NEG,mood=IND,inter=DECL,tense=PST,per=1,num=SG,aspect={IPFV/PROG}	heyecanlandırmıyordum
heyecanlandırırlar	pos=V,polar=POS,mood=IND,inter=DECL,tense=PST,per=3,num=PL,aspect={IPFV/PROG}	heyecanlandırıyorlardı
heyecanlandırıyordun	pos=V,polar=NEG,mood=IND,inter=DECL,tense=PRS,per=1,num=PL,aspect=PROG	heyecanlandırmıyoruz
heyecanlandırmayız	pos=V,polar=POS,mood=IND,inter=DECL,tense=PST,per=3,num=PL,aspect=PFV	heyecanlandırdılar
heyecanlandırmıyordunuz	pos=V,polar=POS,mood=IND,inter=DECL,tense=PST,per=3,num=PL,aspect=PFV	heyecanlandırdılar
heyecanlandırtmıyordunuz	pos=V,polar=POS,mood=IND,inter=DECL,tense=PRS,per=1,num=SG,aspect={IPFV/PFV}	heyecanlandırtırım
heyecanlanır	pos=V,polar=POS,mood=IND,inter=DECL,tense=PRS,per=2,num=SG,aspect=PROG	heyecanlanıyorsun
heyecanlanırsınız	pos=V,polar=POS,mood=IND,inter=DECL,tense=PST,per=1,num=SG,aspect={IPFV/PROG}	heyecanlanıyordum
heyecanlanmadılar	pos=V,polar=POS,mood=IND,inter=DECL,tense=PRS,per=1,num=SG,aspect={IPFV/PFV}	heyecanlanırım
heyecanlanmazsın	pos=V,polar=NEG,mood=IND,inter=DECL,tense=PRS,per=1,num=SG,aspect=PROG	heyecanlanmıyorum
heyecanlanmıyordun	pos=V,polar=POS,mood=IND,inter=DECL,tense=PST,per=3,num=PL,aspect=PFV	heyecanlandılar
hocayız	pos=N,tense=PRS,per=2,num=SG,aspect={IPFV/PFV}	hocasınız
homoseksüelin	pos=N,tense=PRS,per=3,num=SG,aspect={IPFV/PFV}	homoseksüeller
horlamadık	pos=V,polar=POS,mood=IND,inter=DECL,tense=PST,per=3,num=PL,aspect=PFV	horladılar
horlamadın	pos=V,polar=POS,mood=IND,inter=DECL,tense=PRS,per=2,num=SG,aspect=PROG	horluyorsun
horlamıyorsunuz	pos=V,polar=POS,mood=IND,inter=DECL,tense=PRS,per=1,num=PL,aspect=PROG	horluyoruz
horluyorduk	pos=V,polar=NEG,mood=IND,inter=DECL,tense=PST,per=3,num=SG,aspect=PFV	horlamadı
horluyorduk	pos=V,polar=POS,mood=IND,inter=DECL,tense=PRS,per=2,num=PL,aspect=PROG	horluyorsunuz
horluyordu	pos=V,polar=NEG,mood=IND,inter=DECL,tense=PST,per=3,num=SG,aspect={IPFV/PROG}	horlamıyordu
hoşlandı	pos=V,tense=PST,per=2,num=PL,aspect={IPFV/PROG}	hoşlanıyordunuz
hoşlanıyordum	pos=V,tense=PRS,per=1,num=PL,aspect=PROG	hoşlanıyoruz
ibnelerinin	pos=N,tense=PRS,per=3,num=SG,aspect={IPFV/PFV}	ibneler
içerdiler	pos=V,polar=POS,mood=IND,inter=DECL,tense=PST,per=2,num=SG,aspect={IPFV/PROG}	içeriyordun
içeririz	pos=V,polar=NEG,mood=IND,inter=DECL,tense=PRS,per=1,num=PL,aspect={IPFV/PFV}	içermeyiz
içeriyordum	pos=V,polar=POS,mood=IND,inter=DECL,tense=PST,per=3,num=PL,aspect=PFV	içerdiler
içermeyecekler	pos=V,polar=POS,mood=IND,inter=DECL,tense=PRS,per=3,num=SG,aspect=PROG	içeriyor
içersin	pos=V,polar=POS,mood=IND,inter=DECL,tense=PRS,per=1,num=PL,aspect=PROG	içiyoruz
içmedin	pos=V,polar=POS,mood=IND,inter=DECL,tense=PST,per=3,num=SG,aspect=PFV	içti
içmiyordunuz	pos=V,polar=NEG,mood=IND,inter=DECL,tense=PRS,per=2,num=SG,aspect={IPFV/PFV}	içmezsin
içmiyorum	pos=V,polar=POS,mood=IND,inter=DECL,tense=PRS,per=2,num=PL,aspect=PROG	içiyorsunuz
içmiyoruz	pos=V,polar=NEG,mood=IND,inter=DECL,tense=PST,per=3,num=SG,aspect=PFV	içmedi
iffetimizden	pos=N,tense=PRS,per=3,num=SG,aspect={IPFV/PFV}	iffetler
ilerletiyordum	pos=V,polar=NEG,mood=IND,inter=DECL,tense=PRS,per=1,num=PL,aspect=PROG	ilerletmiyoruz
ilerletiyorum	pos=V,polar=POS,mood=IND,inter=DECL,tense=PRS,per=3,num=PL,aspect=PROG	ilerletiyorlar
ilerletmedik	pos=V,polar=POS,mood=IND,inter=DECL,tense=PRS,per=2,num=SG,aspect=PROG	ilerletiyorsun
ilerletmedin	pos=V,polar=POS,mood=IND,inter=DECL,tense=PRS,per=2,num=PL,aspect={IPFV/PFV}	ilerletirsiniz
ilerletmedi	pos=V,polar=NEG,mood=IND,inter=DECL,tense=PRS,per=1,num=SG,aspect=PROG	ilerletmiyorum
ilklendirdin	pos=V,polar=POS,mood=IND,inter=DECL,tense=PST,per=3,num=PL,aspect=PFV	ilklendirdiler
ilklendirmediler	pos=V,polar=NEG,mood=IND,inter=DECL,tense=PST,per=1,num=PL,aspect={IPFV/PROG}	ilklendirmiyorduk
ilklendirmedi	pos=V,polar=NEG,mood=IND,inter=DECL,tense=PRS,per=2,num=SG,aspect=PROG	ilklendirmiyorsun
ilklendirmelerimin	pos=N,tense=PRS,per=3,num=SG,aspect={IPFV/PFV}	ilklendirmeler
ilklendirmiyor	pos=V,polar=NEG,mood=IND,inter=DECL,tense=PST,per=1,num=SG,aspect=PFV	ilklendirmedim
inanıyorlardı	pos=V,polar=POS,mood=IND,inter=DECL,tense=PST,per=3,num=PL,aspect=PFV	inandılar
inanmazsınız	pos=V,polar=NEG,mood=IND,inter=DECL,tense=PRS,per=1,num=SG,aspect={IPFV/PFV}	inanmam
inanmıyorsunuz	pos=V,polar=POS,mood=IND,inter=DECL,tense=PRS,per=3,num=PL,aspect={IPFV/PFV}	inanırlar
incilerime	pos=N,tense=PRS,per=3,num=PL,aspect={IPFV/PFV}	incilerdir
insanımsınızın	pos=N,tense=PRS,per=1,num=PL,aspect={IPFV/PFV}	insanımsılarız
irdeler	pos=V,tense=PST,per=2,num=PL,aspect={IPFV/PROG}	irdeliyordunuz
irdeliyorum	pos=V,tense=PRS,per=1,num=PL,aspect=PROG	irdeliyoruz
irdeliyoruz	pos=V,tense=PRS,per=1,num=SG,aspect={IPFV/PFV}	irdelerim
irkeneği	pos=N,tense=PRS,per=2,num=PL,aspect={IPFV/PFV}	irkeneklersiniz
irkeyellerinizin	pos=N,tense=PRS,per=3,num=PL,aspect={IPFV/PFV}	irkeyellerdir
işedik	pos=V,polar=NEG,mood=IND,inter=DECL,tense=PRS,per=2,num=SG,aspect={IPFV/PFV}	işemezsin
işediler	pos=V,polar=NEG,mood=IND,inter=DECL,tense=PRS,per=1,num=PL,aspect={IPFV/PFV}	işemeyiz
işediler	pos=V,polar=NEG,mood=IND,inter=DECL,tense=PRS,per=3,num=PL,aspect=PROG	işemiyorlar
işemedik	pos=V,polar=POS,mood=IND,inter=DECL,tense=PRS,per=2,num=SG,aspect={IPFV/PFV}	işersin
işemediniz	pos=V,polar=POS,mood=IND,inter=DECL,tense=PST,per=3,num=SG,aspect={IPFV/PROG}	işiyordu
ısırıyordu	pos=V,polar=POS,mood=IND,inter=DECL,tense=PST,per=3,num=SG,aspect=PFV	ısırdı
ısırmayacaksın	pos=V,polar=NEG,mood=IND,inter=DECL,tense=PST,per=3,num=PL,aspect=PFV	ısırmadılar
işkencecilersiniz	pos=N,tense=PRS,per=1,num=PL,aspect={IPFV/PFV}	işkencecileriz
işlediniz	pos=V,polar=NEG,mood=IND,inter=DECL,tense=PST,per=3,num=PL,aspect={IPFV/PROG}	işlemiyordular
işledi	pos=V,polar=NEG,mood=IND,inter=DECL,tense=PRS,per=1,num=SG,aspect=PROG	işlemiyorum
işlemiyorduk	pos=V,polar=NEG,mood=IND,inter=DECL,tense=PST,per=3,num=SG,aspect=PFV	işlemedi
işlerler	pos=V,polar=NEG,mood=IND,inter=DECL,tense=PRS,per=1,num=PL,aspect={IPFV/PFV}	işlemeyiz
ispatlamayacaklar	pos=V,polar=POS,mood=IND,inter=DECL,tense=PST,per=3,num=PL,aspect=PFV	ispatladılar
ispatlamayacaksınız	pos=V,polar=NEG,mood=IND,inter=DECL,tense=PRS,per=3,num=SG,aspect=PROG	ispatlamıyor
ispatlıyorlardı	pos=V,polar=NEG,mood=IND,inter=DECL,tense=PRS,per=1,num=PL,aspect={IPFV/PFV}	ispatlamayız
istemcilerinize	pos=N,tense=PRS,per=1,num=PL,aspect={IPFV/PFV}	istemcileriz
istemeyeceksin	pos=V,polar=NEG,mood=IND,inter=DECL,tense=PRS,per=3,num=SG,aspect={IPFV/PFV}	istemez
istemiyordunuz	pos=V,polar=NEG,mood=IND,inter=DECL,tense=PST,per=1,num=SG,aspect=PFV	istemedim
isterler	pos=V,polar=POS,mood=IND,inter=DECL,tense=PST,per=1,num=SG,aspect={IPFV/PROG}	istiyordum
istiyorlar	pos=V,polar=NEG,mood=IND,inter=DECL,tense=PST,per=1,num=SG,aspect={IPFV/PROG}	istemiyordum
iteceksin	pos=V,polar=NEG,mood=IND,inter=DECL,tense=PRS,per=3,num=PL,aspect={IPFV/PFV}	itmezler
itilmeyecek	pos=V,polar=NEG,mood=IND,inter=DECL,tense=PRS,per=2,num=SG,aspect={IPFV/PFV}	itilmezsin
itilmeyeceksiniz	pos=V,polar=NEG,mood=IND,inter=DECL,tense=PRS,per=2,num=PL,aspect=PROG	itilmiyorsunuz
itilmiyordunuz	pos=V,polar=POS,mood=IND,inter=DECL,tense=PST,per=1,num=PL,aspect=PFV	itildik
itiyordunuz	pos=V,polar=POS,mood=IND,inter=DECL,tense=PRS,per=1,num=SG,aspect={IPFV/PFV}	iterim
itmedi	pos=V,polar=POS,mood=IND,inter=DECL,tense=PRS,per=3,num=PL,aspect=PROG	itiyorlar
itmeyeceğim	pos=V,polar=NEG,mood=IND,inter=DECL,tense=PRS,per=3,num=PL,aspect={IPFV/PFV}	itmezler
ittiniz	pos=V,polar=POS,mood=IND,inter=DECL,tense=PRS,per=1,num=PL,aspect=PROG	itiyoruz
ittirileceksin	pos=V,polar=POS,mood=IND,inter=DECL,tense=PRS,per=3,num=SG,aspect={IPFV/PFV}	ittirilir
ittirilmiyordum	pos=V,polar=POS,mood=IND,inter=DECL,tense=PRS,per=3,num=PL,aspect=PROG	ittiriliyorlar
ittirmediler	pos=V,polar=NEG,mood=IND,inter=DECL,tense=PRS,per=3,num=PL,aspect=PROG	ittirmiyorlar
ittirmezsin	pos=V,polar=POS,mood=IND,inter=DECL,tense=PST,per=1,num=PL,aspect=PFV	ittirdik
ittirmiyordular	pos=V,polar=POS,mood=IND,inter=DECL,tense=PST,per=2,num=PL,aspect=PFV	ittirdiniz
ittirmiyorlar	pos=V,polar=NEG,mood=IND,inter=DECL,tense=PRS,per=2,num=SG,aspect=PROG	ittirmiyorsun
ittirmiyoruz	pos=V,polar=NEG,mood=IND,inter=DECL,tense=PST,per=1,num=SG,aspect={IPFV/PROG}	ittirmiyordum
ittirteceksiniz	pos=V,polar=NEG,mood=IND,inter=DECL,tense=PST,per=2,num=SG,aspect={IPFV/PROG}	ittirtmiyordun
ittirtildin	pos=V,polar=POS,mood=IND,inter=DECL,tense=PST,per=3,num=PL,aspect={IPFV/PROG}	ittirtiliyorlardı
ittirtilecekler	pos=V,polar=POS,mood=IND,inter=DECL,tense=PRS,per=3,num=SG,aspect={IPFV/PFV}	ittirtilir
ittirtiliyorduk	pos=V,polar=NEG,mood=IND,inter=DECL,tense=PRS,per=3,num=PL,aspect={IPFV/PFV}	ittirtilmezler
ittirtilmezler	pos=V,polar=NEG,mood=IND,inter=DECL,tense=PRS,per=1,num=SG,aspect={IPFV/PFV}	ittirtilmem
ittirtiyordum	pos=V,polar=NEG,mood=IND,inter=DECL,tense=PRS,per=1,num=PL,aspect=PROG	ittirtmiyoruz
ittirttiniz	pos=V,polar=POS,mood=IND,inter=DECL,tense=PST,per=2,num=SG,aspect=PFV	ittirttin
iyileşmiyordunuz	pos=V,polar=NEG,mood=IND,inter=DECL,tense=PRS,per=1,num=PL,aspect=PROG	iyileşmiyoruz
iyileşmiyorlar	pos=V,polar=POS,mood=IND,inter=DECL,tense=PST,per=2,num=PL,aspect=PFV	iyileştiniz
iyileştirdim	pos=V,polar=POS,mood=IND,inter=DECL,tense=PST,per=1,num=PL,aspect={IPFV/PROG}	iyileştiriyorduk
iyileştiririm	pos=V,polar=NEG,mood=IND,inter=DECL,tense=PST,per=3,num=PL,aspect=PFV	iyileştirmediler
iyileştirirsin	pos=V,polar=POS,mood=IND,inter=DECL,tense=PST,per=2,num=PL,aspect={IPFV/PROG}	iyileştiriyordunuz
iyileştiriyorlardı	pos=V,polar=NEG,mood=IND,inter=DECL,tense=PST,per=1,num=PL,aspect={IPFV/PROG}	iyileştirmiyorduk
iyileştiriyorlardı	pos=V,polar=POS,mood=IND,inter=DECL,tense=PST,per=1,num=SG,aspect={IPFV/PROG}	iyileştiriyordum
iyileştiriyorum	pos=V,polar=POS,mood=IND,inter=DECL,tense=PRS,per=3,num=SG,aspect=PROG	iyileştiriyor
iyileştirmedi	pos=V,polar=POS,mood=IND,inter=DECL,tense=PST,per=3,num=PL,aspect={IPFV/PROG}	iyileştiriyorlardı
kaçacaklar	pos=V,polar=NEG,mood=IND,inter=DECL,tense=PST,per=1,num=PL,aspect=PFV	kaçmadık
kaçarlar	pos=V,polar=NEG,mood=IND,inter=DECL,tense=PRS,per=2,num=SG,aspect=PROG	kaçmıyorsun
kaçarsın	pos=V,polar=POS,mood=IND,inter=DECL,tense=PRS,per=1,num=SG,aspect=PROG	kaçıyorum
kaçırmazlar	pos=V,polar=POS,mood=IND,inter=DECL,tense=PRS,per=2,num=PL,aspect=PROG	kaçırıyorsunuz
kaçıyordum	pos=V,polar=NEG,mood=IND,inter=DECL,tense=PST,per=3,num=PL,aspect={IPFV/PROG}	kaçmıyordular
kaçıyordun	pos=V,polar=NEG,mood=IND,inter=DECL,tense=PST,per=2,num=SG,aspect=PFV	kaçmadın
kaçıyorlardı	pos=V,polar=NEG,mood=IND,inter=DECL,tense=PST,per=1,num=SG,aspect={IPFV/PROG}	kaçmıyordum
kaçmadınız	pos=V,polar=NEG,mood=IND,inter=DECL,tense=PRS,per=2,num=SG,aspect=PROG	kaçmıyorsun
kaçmayacağım	pos=V,polar=NEG,mood=IND,inter=DECL,tense=PST,per=3,num=PL,aspect={IPFV/PROG}	kaçmıyordular
kaçmıyorsunuz	pos=V,polar=POS,mood=IND,inter=DECL,tense=PST,per=3,num=SG,aspect=PFV	kaçtı
kaçmıyorum	pos=V,polar=NEG,mood=IND,inter=DECL,tense=PRS,per=2,num=PL,aspect={IPFV/PFV}	kaçmazsınız
kadınında	pos=N,tense=PRS,per=3,num=SG,aspect={IPFV/PFV}	kadınlar
kadınlardınız	pos=N,tense=PRS,per=3,num=SG,aspect={IPFV/PFV}	kadınlar
kakarsınız	pos=V,polar=NEG,mood=IND,inter=DECL,tense=PRS,per=2,num=PL,aspect=PROG	kakmıyorsunuz
kakıyorsun	pos=V,polar=POS,mood=IND,inter=DECL,tense=PRS,per=1,num=PL,aspect={IPFV/PFV}	kakarız
kakmıyorlar	pos=V,polar=NEG,mood=IND,inter=DECL,tense=PST,per=3,num=SG,aspect={IPFV/PROG}	kakmıyordu
kalacaksın	pos=V,polar=POS,mood=IND,inter=DECL,tense=PRS,per=2,num=PL,aspect={IPFV/PFV}	kalırsınız
kalıyordu	pos=V,polar=NEG,mood=IND,inter=DECL,tense=PRS,per=3,num=SG,aspect={IPFV/PFV}	kalmaz
kalıyor	pos=V,polar=POS,mood=IND,inter=DECL,tense=PST,per=2,num=PL,aspect=PFV	kaldınız
kalıyorsun	pos=V,polar=NEG,mood=IND,inter=DECL,tense=PRS,per=2,num=PL,aspect=PROG	kalmıyorsunuz
kalmayacak	pos=V,polar=POS,mood=IND,inter=DECL,tense=PRS,per=2,num=PL,aspect={IPFV/PFV}	kalırsınız
kalmayacaksın	pos=V,polar=NEG,mood=IND,inter=DECL,tense=PST,per=3,num=PL,aspect=PFV	kalmadılar
kalmıyordu	pos=V,polar=POS,mood=IND,inter=DECL,tense=PST,per=3,num=SG,aspect=PFV	kaldı
kalmıyorum	pos=V,polar=POS,mood=IND,inter=DECL,tense=PST,per=1,num=SG,aspect={IPFV/PROG}	kalıyordum
kaltaklardı	pos=N,tense=PRS,per=1,num=SG,aspect={IPFV/PFV}	kaltağız
kamusumun	pos=N,tense=PRS,per=2,num=SG,aspect={IPFV/PFV}	kamussunuz
kamusumuza	pos=N,tense=PRS,per=2,num=PL,aspect={IPFV/PFV}	kamuslarsınız
kanamadın	pos=V,polar=POS,mood=IND,inter=DECL,tense=PST,per=1,num=SG,aspect={IPFV/PROG}	kanıyordum
kanıtladınız	pos=V,polar=POS,mood=IND,inter=DECL,tense=PST,per=1,num=PL,aspect=PFV	kanıtladık
kanıtlamadım	pos=V,polar=POS,mood=IND,inter=DECL,tense=PRS,per=1,num=SG,aspect={IPFV/PFV}	kanıtlarım
kanıtlamadım	pos=V,polar=POS,mood=IND,inter=DECL,tense=PST,per=2,num=PL,aspect={IPFV/PROG}	kanıtlıyordunuz
kanıtlamam	pos=V,polar=NEG,mood=IND,inter=DECL,tense=PRS,per=3,num=PL,aspect={IPFV/PFV}	kanıtlamazlar
kanıtlamayız	pos=V,polar=NEG,mood=IND,inter=DECL,tense=PST,per=2,num=SG,aspect={IPFV/PROG}	kanıtlamıyordun
kanıtlamazsın	pos=V,polar=NEG,mood=IND,inter=DECL,tense=PST,per=1,num=SG,aspect={IPFV/PROG}	kanıtlamıyordum
kanıtlayacak	pos=V,polar=POS,mood=IND,inter=DECL,tense=PRS,per=1,num=PL,aspect=PROG	kanıtlıyoruz
kanıtlayacaksın	pos=V,polar=NEG,mood=IND,inter=DECL,tense=PST,per=2,num=SG,aspect=PFV	kanıtlamadın
kanıyorlar	pos=V,polar=NEG,mood=IND,inter=DECL,tense=PRS,per=2,num=SG,aspect=PROG	kanamıyorsun
kapatıyorsunuz	pos=V,polar=NEG,mood=IND,inter=DECL,tense=PRS,per=2,num=SG,aspect=PROG	kapatmıyorsun
kapatıyoruz	pos=V,polar=NEG,mood=IND,inter=DECL,tense=PST,per=3,num=SG,aspect={IPFV/PROG}	kapatmıyordu
kapatmadık	pos=V,polar=POS,mood=IND,inter=DECL,tense=PST,per=1,num=SG,aspect={IPFV/PROG}	kapatıyordum
kapatmam	pos=V,polar=POS,mood=IND,inter=DECL,tense=PST,per=3,num=SG,aspect=PFV	kapattı
kapatmayacaklar	pos=V,polar=NEG,mood=IND,inter=DECL,tense=PRS,per=3,num=PL,aspect={IPFV/PFV}	kapatmazlar
kapatmıyorlar	pos=V,polar=NEG,mood=IND,inter=DECL,tense=PRS,per=1,num=PL,aspect={IPFV/PFV}	kapatmayız
kapatmıyoruz	pos=V,polar=POS,mood=IND,inter=DECL,tense=PST,per=1,num=PL,aspect=PFV	kapattık
kapattım	pos=V,polar=NEG,mood=IND,inter=DECL,tense=PST,per=1,num=PL,aspect=PFV	kapatmadık
karakterlerini	pos=N,tense=PRS,per=3,num=PL,aspect={IPFV/PFV}	karakterlerdir
kararacak	pos=V,polar=POS,mood=IND,inter=DECL,tense=PST,per=2,num=SG,aspect=PFV	karartın
kararmayacağım	pos=V,polar=NEG,mood=IND,inter=DECL,tense=PST,per=1,num=PL,aspect=PFV	kararmadık
kararmayacaksın	pos=V,polar=NEG,mood=IND,inter=DECL,tense=PRS,per=1,num=SG,aspect=PROG	kararmıyorum
karartı	pos=V,polar=POS,mood=IND,inter=DECL,tense=PST,per=1,num=PL,aspect=PFV	karartık
karınızda	pos=N,tense=PRS,per=1,num=PL,aspect={IPFV/PFV}	karılarız
karıştırdı	pos=V,polar=POS,mood=IND,inter=DECL,tense=PRS,per=3,num=PL,aspect=PROG	karıştırıyorlar
karıştırırım	pos=V,polar=POS,mood=IND,inter=DECL,tense=PRS,per=3,num=PL,aspect=PROG	karıştırıyorlar
karıştırırız	pos=V,polar=POS,mood=IND,inter=DECL,tense=PST,per=3,num=PL,aspect={IPFV/PROG}	karıştırıyorlardı
karıştırmayacağım	pos=V,polar=POS,mood=IND,inter=DECL,tense=PRS,per=2,num=SG,aspect={IPFV/PFV}	karıştırırsın
karıştırmıyoruz	pos=V,polar=POS,mood=IND,inter=DECL,tense=PRS,per=1,num=SG,aspect={IPFV/PFV}	karıştırırım
karıştırtacaksınız	pos=V,polar=NEG,mood=IND,inter=DECL,tense=PRS,per=2,num=PL,aspect=PROG	karıştırtmıyorsunuz
karıştırtıyorlardı	pos=V,polar=POS,mood=IND,inter=DECL,tense=PRS,per=2,num=PL,aspect=PROG	karıştırtıyorsunuz
karıştırtmadınız	pos=V,polar=NEG,mood=IND,inter=DECL,tense=PST,per=1,num=PL,aspect={IPFV/PROG}	karıştırtmıyorduk
karıştırtmadı	pos=V,polar=NEG,mood=IND,inter=DECL,tense=PST,per=3,num=PL,aspect=PFV	karıştırtmadılar
karıştırtmıyor	pos=V,polar=NEG,mood=IND,inter=DECL,tense=PST,per=2,num=PL,aspect={IPFV/PROG}	karıştırtmıyordunuz
karnende	pos=N,tense=PRS,per=1,num=SG,aspect={IPFV/PFV}	karneyiz
karpuzlardı	pos=N,tense=PRS,per=1,num=SG,aspect={IPFV/PFV}	karpuzuz
kaşarını	pos=N,tense=PRS,per=1,num=PL,aspect={IPFV/PFV}	kaşarlarız
kasideleri	pos=N,tense=PRS,per=2,num=PL,aspect={IPFV/PFV}	kasidelersiniz
katılacaklar	pos=V,polar=POS,mood=IND,inter=DECL,tense=PST,per=2,num=SG,aspect=PFV	katıldın
katılaşıyorlar	pos=V,polar=NEG,mood=IND,inter=DECL,tense=PRS,per=2,num=PL,aspect={IPFV/PFV}	katılaşmazsınız
katılaşıyorsunuz	pos=V,polar=NEG,mood=IND,inter=DECL,tense=PRS,per=3,num=PL,aspect={IPFV/PFV}	katılaşmazlar
katılaşmıyordun	pos=V,polar=POS,mood=IND,inter=DECL,tense=PRS,per=2,num=PL,aspect={IPFV/PFV}	katılaşırsınız
katılaşmıyorsunuz	pos=V,polar=NEG,mood=IND,inter=DECL,tense=PST,per=2,num=PL,aspect={IPFV/PROG}	katılaşmıyordunuz
katılaştıracağım	pos=V,polar=POS,mood=IND,inter=DECL,tense=PRS,per=3,num=SG,aspect=PROG	katılaştırıyor
katılaştırırlar	pos=V,polar=NEG,mood=IND,inter=DECL,tense=PST,per=1,num=PL,aspect=PFV	katılaştırmadık
katılaştırıyorsun	pos=V,polar=NEG,mood=IND,inter=DECL,tense=PST,per=3,num=PL,aspect={IPFV/PROG}	katılaştırmıyordular
katıldılar	pos=V,polar=NEG,mood=IND,inter=DECL,tense=PRS,per=3,num=PL,aspect=PROG	katılmıyorlar
katıldı	pos=V,polar=NEG,mood=IND,inter=DECL,tense=PST,per=1,num=SG,aspect={IPFV/PROG}	katılmıyordum
katilimi	pos=N,tense=PRS,per=1,num=PL,aspect={IPFV/PFV}	katilleriz
katılıyorduk	pos=V,polar=NEG,mood=IND,inter=DECL,tense=PST,per=3,num=PL,aspect=PFV	katılmadılar
katılmıyor	pos=V,polar=NEG,mood=IND,inter=DECL,tense=PRS,per=2,num=SG,aspect=PROG	katılmıyorsun
kaybolmadılar	pos=V,polar=POS,mood=IND,inter=DECL,tense=PRS,per=1,num=PL,aspect={IPFV/PFV}	kayboluruz
kaybolmazsın	pos=V,polar=NEG,mood=IND,inter=DECL,tense=PRS,per=3,num=SG,aspect=PROG	kaybolmuyor
kaynaşacaksın	pos=V,polar=NEG,mood=IND,inter=DECL,tense=PRS,per=3,num=SG,aspect={IPFV/PFV}	kaynaşmaz
kaynaşıyordunuz	pos=V,polar=POS,mood=IND,inter=DECL,tense=PRS,per=2,num=PL,aspect=PROG	kaynaşıyorsunuz
kaynaşıyordu	pos=V,polar=POS,mood=IND,inter=DECL,tense=PST,per=3,num=PL,aspect=PFV	kaynaştılar
kaynaşmayız	pos=V,polar=POS,mood=IND,inter=DECL,tense=PST,per=3,num=PL,aspect={IPFV/PROG}	kaynaşıyorlardı
kaynaştınız	pos=V,polar=NEG,mood=IND,inter=DECL,tense=PST,per=3,num=PL,aspect=PFV	kaynaşmadılar
kaynaştın	pos=V,polar=NEG,mood=IND,inter=DECL,tense=PST,per=3,num=SG,aspect={IPFV/PROG}	kaynaşmıyordu
kaynaştıracaklar	pos=V,polar=NEG,mood=IND,inter=DECL,tense=PST,per=1,num=SG,aspect={IPFV/PROG}	kaynaştırmıyordum
kaynaştırıldık	pos=V,polar=POS,mood=IND,inter=DECL,tense=PRS,per=1,num=SG,aspect=PROG	kaynaştırılıyorum
kaynaştırılırım	pos=V,polar=NEG,mood=IND,inter=DECL,tense=PST,per=1,num=PL,aspect={IPFV/PROG}	kaynaştırılmıyorduk
kaynaştırılıyorum	pos=V,polar=POS,mood=IND,inter=DECL,tense=PST,per=1,num=SG,aspect=PFV	kaynaştırıldım
kaynaştırırsınız	pos=V,polar=POS,mood=IND,inter=DECL,tense=PST,per=1,num=PL,aspect=PFV	kaynaştırdık
kaynaştırıyorsun	pos=V,polar=NEG,mood=IND,inter=DECL,tense=PST,per=3,num=SG,aspect={IPFV/PROG}	kaynaştırmıyordu
kaynaştırmayacaksın	pos=V,polar=NEG,mood=IND,inter=DECL,tense=PST,per=3,num=PL,aspect=PFV	kaynaştırmadılar
kaynaştırmayacaksın	pos=V,polar=POS,mood=IND,inter=DECL,tense=PRS,per=2,num=SG,aspect={IPFV/PFV}	kaynaştırırsın
kaynaştırmaz	pos=V,polar=NEG,mood=IND,inter=DECL,tense=PST,per=2,num=PL,aspect={IPFV/PROG}	kaynaştırmıyordunuz
kaynaştırmıyordun	pos=V,polar=POS,mood=IND,inter=DECL,tense=PRS,per=1,num=PL,aspect=PROG	kaynaştırıyoruz
kaynaştırtacaksınız	pos=V,polar=POS,mood=IND,inter=DECL,tense=PRS,per=3,num=SG,aspect=PROG	kaynaştırtıyor
kaynaştırtılacak	pos=V,polar=NEG,mood=IND,inter=DECL,tense=PST,per=3,num=PL,aspect=PFV	kaynaştırtılmadılar
kaynaştırtılırsın	pos=V,polar=NEG,mood=IND,inter=DECL,tense=PRS,per=3,num=PL,aspect=PROG	kaynaştırtılmıyorlar
kaynaştırtmadınız	pos=V,polar=NEG,mood=IND,inter=DECL,tense=PRS,per=3,num=PL,aspect={IPFV/PFV}	kaynaştırtmazlar
kaynaştırtmayacaksın	pos=V,polar=NEG,mood=IND,inter=DECL,tense=PRS,per=1,num=SG,aspect={IPFV/PFV}	kaynaştırtmam
kazanacağız	pos=V,polar=POS,mood=IND,inter=DECL,tense=PRS,per=1,num=PL,aspect=PROG	kazanıyoruz
kazanıyorlardı	pos=V,polar=POS,mood=IND,inter=DECL,tense=PST,per=1,num=PL,aspect={IPFV/PROG}	kazanıyorduk
kazanıyorsun	pos=V,polar=NEG,mood=IND,inter=DECL,tense=PST,per=2,num=PL,aspect=PFV	kazanmadınız
kazanmayacağım	pos=V,polar=NEG,mood=IND,inter=DECL,tense=PRS,per=1,num=SG,aspect={IPFV/PFV}	kazanmam
kazanmayız	pos=V,polar=POS,mood=IND,inter=DECL,tense=PRS,per=2,num=SG,aspect=PROG	kazanıyorsun
kazanmıyordu	pos=V,polar=POS,mood=IND,inter=DECL,tense=PST,per=3,num=SG,aspect=PFV	kazandı
kazarlar	pos=V,polar=NEG,mood=IND,inter=DECL,tense=PRS,per=1,num=SG,aspect={IPFV/PFV}	kazmam
kazar	pos=V,polar=NEG,mood=IND,inter=DECL,tense=PST,per=3,num=PL,aspect=PFV	kazmadılar
kazıyordu	pos=V,polar=NEG,mood=IND,inter=DECL,tense=PST,per=1,num=SG,aspect=PFV	kazmadım
kazıyorsunuz	pos=V,polar=POS,mood=IND,inter=DECL,tense=PST,per=3,num=SG,aspect=PFV	kazdı
kazıyoruz	pos=V,polar=POS,mood=IND,inter=DECL,tense=PST,per=2,num=SG,aspect=PFV	kazdın
kazmıyorlar	pos=V,polar=NEG,mood=IND,inter=DECL,tense=PRS,per=3,num=PL,aspect={IPFV/PFV}	kazmazlar
kazmıyor	pos=V,polar=POS,mood=IND,inter=DECL,tense=PST,per=1,num=PL,aspect={IPFV/PROG}	kazıyorduk
kedicik	pos=N,tense=PRS,per=3,num=SG,aspect={IPFV/PFV}	kedicikler
keseceksin	pos=V,polar=NEG,mood=IND,inter=DECL,tense=PRS,per=1,num=SG,aspect={IPFV/PFV}	kesmem
keseceksin	pos=V,polar=POS,mood=IND,inter=DECL,tense=PRS,per=3,num=SG,aspect=PROG	kesiyor
keşfeder	pos=V,polar=POS,mood=IND,inter=DECL,tense=PRS,per=2,num=SG,aspect=PROG	keşfetiyorsun
keşfedersin	pos=V,polar=POS,mood=IND,inter=DECL,tense=PST,per=3,num=PL,aspect={IPFV/PROG}	keşfetiyorlardı
keşfetecekler	pos=V,polar=NEG,mood=IND,inter=DECL,tense=PST,per=1,num=PL,aspect={IPFV/PROG}	keşfetmiyorduk
keşfetmeyeceğiz	pos=V,polar=NEG,mood=IND,inter=DECL,tense=PST,per=3,num=SG,aspect=PFV	keşfetmedi
keşfetmiyorsun	pos=V,polar=NEG,mood=IND,inter=DECL,tense=PRS,per=1,num=PL,aspect=PROG	keşfetmiyoruz
keşfetmiyoruz	pos=V,polar=POS,mood=IND,inter=DECL,tense=PST,per=1,num=PL,aspect=PFV	keşfettik
kesiyorlar	pos=V,polar=POS,mood=IND,inter=DECL,tense=PRS,per=1,num=SG,aspect=PROG	kesiyorum
kesmedi	pos=V,polar=POS,mood=IND,inter=DECL,tense=PRS,per=1,num=PL,aspect={IPFV/PFV}	keseriz
kesmiyordun	pos=V,polar=NEG,mood=IND,inter=DECL,tense=PRS,per=2,num=PL,aspect=PROG	kesmiyorsunuz
kestiniz	pos=V,polar=POS,mood=IND,inter=DECL,tense=PST,per=2,num=PL,aspect={IPFV/PROG}	kesiyordunuz
kıracak	pos=V,polar=POS,mood=IND,inter=DECL,tense=PST,per=3,num=SG,aspect=PFV	kırdı
kırdırıyordu	pos=V,polar=POS,mood=IND,inter=DECL,tense=PST,per=1,num=PL,aspect=PFV	kırdırdık
kırdırıyorum	pos=V,polar=POS,mood=IND,inter=DECL,tense=PST,per=2,num=PL,aspect={IPFV/PROG}	kırdırıyordunuz
kırdırmadık	pos=V,polar=POS,mood=IND,inter=DECL,tense=PRS,per=3,num=PL,aspect={IPFV/PFV}	kırdırırlar
kırdırmadılar	pos=V,polar=POS,mood=IND,inter=DECL,tense=PST,per=3,num=PL,aspect={IPFV/PROG}	kırdırıyorlardı
kırdırmadınız	pos=V,polar=POS,mood=IND,inter=DECL,tense=PRS,per=1,num=SG,aspect=PROG	kırdırıyorum
kırdırmayacaklar	pos=V,polar=POS,mood=IND,inter=DECL,tense=PST,per=1,num=PL,aspect={IPFV/PROG}	kırdırıyorduk
kırdırmayacaksın	pos=V,polar=NEG,mood=IND,inter=DECL,tense=PST,per=3,num=SG,aspect={IPFV/PROG}	kırdırmıyordu
kırdırtıyoruz	pos=V,polar=NEG,mood=IND,inter=DECL,tense=PST,per=1,num=PL,aspect={IPFV/PROG}	kırdırtmıyorduk
kırdırtmıyordu	pos=V,polar=POS,mood=IND,inter=DECL,tense=PST,per=2,num=PL,aspect={IPFV/PROG}	kırdırtıyordunuz
kırıldın	pos=V,polar=NEG,mood=IND,inter=DECL,tense=PRS,per=1,num=SG,aspect={IPFV/PFV}	kırılmam
kırıldın	pos=V,polar=POS,mood=IND,inter=DECL,tense=PST,per=1,num=PL,aspect=PFV	kırıldık
kırılırlar	pos=V,polar=NEG,mood=IND,inter=DECL,tense=PST,per=2,num=SG,aspect=PFV	kırılmadın
kırılıyorduk	pos=V,polar=NEG,mood=IND,inter=DECL,tense=PST,per=3,num=SG,aspect={IPFV/PROG}	kırılmıyordu
kırılmadınız	pos=V,polar=NEG,mood=IND,inter=DECL,tense=PRS,per=2,num=SG,aspect=PROG	kırılmıyorsun
kırılmam	pos=V,polar=POS,mood=IND,inter=DECL,tense=PST,per=3,num=PL,aspect={IPFV/PROG}	kırılıyorlardı
kırılmıyordu	pos=V,polar=POS,mood=IND,inter=DECL,tense=PRS,per=2,num=SG,aspect={IPFV/PFV}	kırılırsın
kırıtacak	pos=V,polar=NEG,mood=IND,inter=DECL,tense=PST,per=2,num=PL,aspect={IPFV/PROG}	kırıtmıyordunuz
kırıtırız	pos=V,polar=NEG,mood=IND,inter=DECL,tense=PRS,per=3,num=SG,aspect={IPFV/PFV}	kırıtmaz
kırıyorlar	pos=V,polar=NEG,mood=IND,inter=DECL,tense=PRS,per=2,num=PL,aspect=PROG	kırmıyorsunuz
kırıyorum	pos=V,polar=POS,mood=IND,inter=DECL,tense=PST,per=1,num=SG,aspect=PFV	kırdım
kirleteceksiniz	pos=V,polar=NEG,mood=IND,inter=DECL,tense=PST,per=2,num=PL,aspect=PFV	kirletmediniz
kirletmedim	pos=V,polar=POS,mood=IND,inter=DECL,tense=PRS,per=1,num=PL,aspect={IPFV/PFV}	kirletiriz
kirletmeyeceksiniz	pos=V,polar=POS,mood=IND,inter=DECL,tense=PST,per=1,num=SG,aspect={IPFV/PROG}	kirletiyordum
kirletmeyeceksiniz	pos=V,polar=POS,mood=IND,inter=DECL,tense=PST,per=2,num=PL,aspect={IPFV/PROG}	kirletiyordunuz
kirlettik	pos=V,polar=NEG,mood=IND,inter=DECL,tense=PST,per=3,num=PL,aspect={IPFV/PROG}	kirletmiyordular
kırmayacaksın	pos=V,polar=POS,mood=IND,inter=DECL,tense=PST,per=3,num=PL,aspect=PFV	kırdılar
kırmıyorsunuz	pos=V,polar=NEG,mood=IND,inter=DECL,tense=PST,per=3,num=SG,aspect=PFV	kırmadı
kirpini	pos=N,tense=PRS,per=1,num=SG,aspect={IPFV/PFV}	kirpiyiz
kırtasiyelerin	pos=N,tense=PRS,per=3,num=SG,aspect={IPFV/PFV}	kırtasiyeler
kıskanacağım	pos=V,polar=POS,mood=IND,inter=DECL,tense=PST,per=3,num=SG,aspect=PFV	kıskandı
kıskanıyorlardı	pos=V,polar=NEG,mood=IND,inter=DECL,tense=PRS,per=2,num=SG,aspect={IPFV/PFV}	kıskanmazsın
kıskanıyorsun	pos=V,polar=NEG,mood=IND,inter=DECL,tense=PRS,per=2,num=SG,aspect={IPFV/PFV}	kıskanmazsın
kıskanmadık	pos=V,polar=NEG,mood=IND,inter=DECL,tense=PST,per=1,num=PL,aspect={IPFV/PROG}	kıskanmıyorduk
kıskanmazsınız	pos=V,polar=POS,mood=IND,inter=DECL,tense=PST,per=3,num=SG,aspect={IPFV/PROG}	kıskanıyordu
kıskanmıyorduk	pos=V,polar=POS,mood=IND,inter=DECL,tense=PRS,per=3,num=PL,aspect={IPFV/PFV}	kıskanırlar
kıskanmıyordu	pos=V,polar=NEG,mood=IND,inter=DECL,tense=PRS,per=1,num=SG,aspect={IPFV/PFV}	kıskanmam
kışkırtacak	pos=V,polar=POS,mood=IND,inter=DECL,tense=PRS,per=3,num=SG,aspect={IPFV/PFV}	kışkırtır
kışkırtıyorlar	pos=V,polar=NEG,mood=IND,inter=DECL,tense=PST,per=2,num=PL,aspect={IPFV/PROG}	kışkırtmıyordunuz
kıyafetim	pos=N,tense=PRS,per=3,num=PL,aspect={IPFV/PFV}	kıyafetlerdir
kıyafetinizden	pos=N,tense=PRS,per=1,num=PL,aspect={IPFV/PFV}	kıyafetleriz
kıyafetiniz	pos=N,tense=PRS,per=1,num=PL,aspect={IPFV/PFV}	kıyafetleriz
kızacağım	pos=V,polar=NEG,mood=IND,inter=DECL,tense=PRS,per=3,num=PL,aspect={IPFV/PFV}	kızmazlar
kızıyordum	pos=V,polar=NEG,mood=IND,inter=DECL,tense=PST,per=3,num=PL,aspect=PFV	kızmadılar
kızıyordun	pos=V,polar=POS,mood=IND,inter=DECL,tense=PRS,per=3,num=SG,aspect={IPFV/PFV}	kızar
kokarım	pos=V,polar=POS,mood=IND,inter=DECL,tense=PRS,per=2,num=PL,aspect={IPFV/PFV}	kokarsınız
koklamazsınız	pos=V,polar=NEG,mood=IND,inter=DECL,tense=PST,per=3,num=SG,aspect={IPFV/PROG}	koklamıyordu
koklamıyordunuz	pos=V,polar=NEG,mood=IND,inter=DECL,tense=PST,per=3,num=PL,aspect={IPFV/PROG}	koklamıyordular
koklamıyordunuz	pos=V,polar=POS,mood=IND,inter=DECL,tense=PRS,per=2,num=SG,aspect=PROG	kokluyorsun
koklamıyorsun	pos=V,polar=POS,mood=IND,inter=DECL,tense=PST,per=1,num=PL,aspect={IPFV/PROG}	kokluyorduk
koklarsın	pos=V,polar=POS,mood=IND,inter=DECL,tense=PRS,per=1,num=PL,aspect={IPFV/PFV}	koklarız
koklayacaklar	pos=V,polar=NEG,mood=IND,inter=DECL,tense=PRS,per=3,num=PL,aspect={IPFV/PFV}	koklamazlar
komikleşecek	pos=V,polar=NEG,mood=IND,inter=DECL,tense=PST,per=3,num=SG,aspect=PFV	komikleşmedi
komikleşirler	pos=V,polar=NEG,mood=IND,inter=DECL,tense=PRS,per=1,num=SG,aspect={IPFV/PFV}	komikleşmem
komikleşmedik	pos=V,polar=POS,mood=IND,inter=DECL,tense=PST,per=3,num=PL,aspect=PFV	komikleştiler
komikleşmem	pos=V,polar=POS,mood=IND,inter=DECL,tense=PRS,per=1,num=PL,aspect=PROG	komikleşiyoruz
komikleşmeyecekler	pos=V,polar=NEG,mood=IND,inter=DECL,tense=PST,per=2,num=PL,aspect={IPFV/PROG}	komikleşmiyordunuz
komikleşmiyorsunuz	pos=V,polar=POS,mood=IND,inter=DECL,tense=PRS,per=1,num=PL,aspect={IPFV/PFV}	komikleşiriz
komikleştiniz	pos=V,polar=NEG,mood=IND,inter=DECL,tense=PST,per=2,num=SG,aspect={IPFV/PROG}	komikleşmiyordun
konmayacaksın	pos=V,polar=POS,mood=IND,inter=DECL,tense=PST,per=2,num=SG,aspect={IPFV/PROG}	konuyordun
konularının	pos=N,tense=PRS,per=3,num=SG,aspect={IPFV/PFV}	konular
konuşmayacaklar	pos=V,polar=NEG,mood=IND,inter=DECL,tense=PRS,per=3,num=SG,aspect={IPFV/PFV}	konuşmaz
konuşmuyordular	pos=V,polar=NEG,mood=IND,inter=DECL,tense=PST,per=3,num=SG,aspect=PFV	konuşmadı
konuştum	pos=V,polar=POS,mood=IND,inter=DECL,tense=PRS,per=2,num=PL,aspect={IPFV/PFV}	konuşursunuz
köpürmüyordunuz	pos=V,polar=NEG,mood=IND,inter=DECL,tense=PRS,per=1,num=PL,aspect=PROG	köpürmüyoruz
köpürteceksiniz	pos=V,polar=POS,mood=IND,inter=DECL,tense=PRS,per=2,num=PL,aspect={IPFV/PFV}	köpürtürsünüz
köpürtmediniz	pos=V,polar=NEG,mood=IND,inter=DECL,tense=PST,per=1,num=PL,aspect={IPFV/PROG}	köpürtmüyorduk
köpürtmedi	pos=V,polar=NEG,mood=IND,inter=DECL,tense=PRS,per=3,num=PL,aspect={IPFV/PFV}	köpürtmezler
köpürtüyorduk	pos=V,polar=NEG,mood=IND,inter=DECL,tense=PRS,per=3,num=SG,aspect=PROG	köpürtmüyor
köpürüyoruz	pos=V,polar=POS,mood=IND,inter=DECL,tense=PST,per=2,num=PL,aspect=PFV	köpürdünüz
korkmadık	pos=V,polar=POS,mood=IND,inter=DECL,tense=PRS,per=1,num=SG,aspect={IPFV/PFV}	korkarım
korkmuyordunuz	pos=V,polar=NEG,mood=IND,inter=DECL,tense=PRS,per=3,num=PL,aspect=PROG	korkmuyorlar
korkmuyordu	pos=V,polar=NEG,mood=IND,inter=DECL,tense=PST,per=1,num=SG,aspect=PFV	korkmadım
korktular	pos=V,polar=NEG,mood=IND,inter=DECL,tense=PRS,per=1,num=PL,aspect=PROG	korkmuyoruz
korktum	pos=V,polar=POS,mood=IND,inter=DECL,tense=PST,per=3,num=SG,aspect={IPFV/PROG}	korkuyordu
korkutacak	pos=V,polar=POS,mood=IND,inter=DECL,tense=PRS,per=2,num=SG,aspect=PROG	korkutuyorsun
korkutmadılar	pos=V,polar=POS,mood=IND,inter=DECL,tense=PST,per=2,num=PL,aspect={IPFV/PROG}	korkutuyordunuz
korkutmayacaksınız	pos=V,polar=NEG,mood=IND,inter=DECL,tense=PST,per=1,num=PL,aspect=PFV	korkutmadık
koşacağım	pos=V,polar=POS,mood=IND,inter=DECL,tense=PST,per=3,num=SG,aspect={IPFV/PROG}	koşuyordu
koşmayacağım	pos=V,polar=NEG,mood=IND,inter=DECL,tense=PST,per=3,num=SG,aspect=PFV	koşmadı
koşmaz	pos=V,polar=POS,mood=IND,inter=DECL,tense=PRS,per=3,num=SG,aspect={IPFV/PFV}	koşar
koştunuz	pos=V,polar=NEG,mood=IND,inter=DECL,tense=PST,per=3,num=PL,aspect={IPFV/PROG}	koşmuyordular
koşturtmadın	pos=V,polar=NEG,mood=IND,inter=DECL,tense=PRS,per=1,num=SG,aspect={IPFV/PFV}	koşturtmam
koşturtmam	pos=V,polar=POS,mood=IND,inter=DECL,tense=PST,per=3,num=SG,aspect=PFV	koşturttu
koşturtmayacağız	pos=V,polar=NEG,mood=IND,inter=DECL,tense=PST,per=1,num=PL,aspect={IPFV/PROG}	koşturtmuyorduk
koşturtmazlar	pos=V,polar=NEG,mood=IND,inter=DECL,tense=PRS,per=3,num=PL,aspect=PROG	koşturtmuyorlar
koşturtuyorduk	pos=V,polar=NEG,mood=IND,inter=DECL,tense=PST,per=3,num=SG,aspect=PFV	koşturtmadı
koşturtuyordu	pos=V,polar=POS,mood=IND,inter=DECL,tense=PST,per=2,num=PL,aspect=PFV	koşturttunuz
koşturtuyorsunuz	pos=V,polar=POS,mood=IND,inter=DECL,tense=PRS,per=1,num=SG,aspect={IPFV/PFV}	koştururım
koşturtuyoruz	pos=V,polar=POS,mood=IND,inter=DECL,tense=PRS,per=3,num=SG,aspect={IPFV/PFV}	koşturtur
koşulmuyorum	pos=V,polar=POS,mood=IND,inter=DECL,tense=PST,per=2,num=SG,aspect=PFV	koşuldun
koşuluyordum	pos=V,polar=POS,mood=IND,inter=DECL,tense=PRS,per=3,num=SG,aspect={IPFV/PFV}	koşulur
koşuluyordu	pos=V,polar=POS,mood=IND,inter=DECL,tense=PST,per=3,num=PL,aspect={IPFV/PROG}	koşuluyorlardı
kötüleşecekler	pos=V,polar=POS,mood=IND,inter=DECL,tense=PRS,per=2,num=PL,aspect={IPFV/PFV}	kötüleşirsiniz
kötüleşir	pos=V,polar=NEG,mood=IND,inter=DECL,tense=PRS,per=2,num=PL,aspect=PROG	kötüleşmiyorsunuz
kötüleşmeyeceğim	pos=V,polar=NEG,mood=IND,inter=DECL,tense=PST,per=1,num=PL,aspect=PFV	kötüleşmedik
kötüleşmiyordum	pos=V,polar=NEG,mood=IND,inter=DECL,tense=PST,per=2,num=PL,aspect=PFV	kötüleşmediniz
kötüleştireceksiniz	pos=V,polar=POS,mood=IND,inter=DECL,tense=PRS,per=2,num=SG,aspect={IPFV/PFV}	kötüleştirirsin
kötüleştirirsiniz	pos=V,polar=POS,mood=IND,inter=DECL,tense=PST,per=1,num=PL,aspect=PFV	kötüleştirdik
kötüleştiriyorlar	pos=V,polar=POS,mood=IND,inter=DECL,tense=PST,per=2,num=PL,aspect=PFV	kötüleştirdiniz
kötüleştirmiyordun	pos=V,polar=POS,mood=IND,inter=DECL,tense=PST,per=2,num=SG,aspect={IPFV/PROG}	kötüleştiriyordun
kötüleştirmiyordun	pos=V,polar=POS,mood=IND,inter=DECL,tense=PST,per=3,num=PL,aspect=PFV	kötüleştirdiler
koyacaksın	pos=V,polar=NEG,mood=IND,inter=DECL,tense=PRS,per=2,num=PL,aspect=PROG	koymuyorsunuz
köygöçürenlerde	pos=N,tense=PRS,per=1,num=SG,aspect={IPFV/PFV}	köygöçüreniz
köygöçürenlersiniz	pos=N,tense=PRS,per=1,num=PL,aspect={IPFV/PFV}	köygöçürenleriz
koyulaşır	pos=V,polar=POS,mood=IND,inter=DECL,tense=PRS,per=2,num=PL,aspect=PROG	koyulaşıyorsunuz
koyulaşırsın	pos=V,polar=NEG,mood=IND,inter=DECL,tense=PST,per=2,num=PL,aspect={IPFV/PROG}	koyulaşmıyordunuz
koyulaşıyordunuz	pos=V,polar=NEG,mood=IND,inter=DECL,tense=PST,per=2,num=PL,aspect=PFV	koyulaşmadınız
koyulaşıyordu	pos=V,polar=POS,mood=IND,inter=DECL,tense=PRS,per=3,num=SG,aspect={IPFV/PFV}	koyulaşır
koyulaşıyorsunuz	pos=V,polar=POS,mood=IND,inter=DECL,tense=PST,per=3,num=PL,aspect=PFV	koyulaştılar
koyulaşmadılar	pos=V,polar=NEG,mood=IND,inter=DECL,tense=PST,per=2,num=PL,aspect={IPFV/PROG}	koyulaşmıyordunuz
koyulaşmazsınız	pos=V,polar=POS,mood=IND,inter=DECL,tense=PRS,per=3,num=SG,aspect=PROG	koyulaşıyor
koyulaştılar	pos=V,polar=NEG,mood=IND,inter=DECL,tense=PST,per=2,num=PL,aspect=PFV	koyulaşmadınız
küçüldü	pos=V,polar=NEG,mood=IND,inter=DECL,tense=PRS,per=1,num=PL,aspect=PROG	küçülmüyoruz
küçüleceğiz	pos=V,polar=NEG,mood=IND,inter=DECL,tense=PRS,per=3,num=PL,aspect=PROG	küçülmüyorlar
küçülmeyeceğiz	pos=V,polar=NEG,mood=IND,inter=DECL,tense=PST,per=2,num=SG,aspect=PFV	küçülmedin
küçülürüm	pos=V,polar=NEG,mood=IND,inter=DECL,tense=PRS,per=1,num=SG,aspect=PROG	küçülmüyorum
kullanıcılarınızda	pos=N,tense=PRS,per=1,num=SG,aspect={IPFV/PFV}	kullanıcıyız
kullanılırız	pos=V,polar=NEG,mood=IND,inter=DECL,tense=PST,per=3,num=SG,aspect={IPFV/PROG}	kullanılmıyordu
kullanılmadılar	pos=V,polar=NEG,mood=IND,inter=DECL,tense=PRS,per=1,num=PL,aspect={IPFV/PFV}	kullanılmayız
kullanılmam	pos=V,polar=POS,mood=IND,inter=DECL,tense=PRS,per=1,num=PL,aspect={IPFV/PFV}	kullanılırız
kullanırız	pos=V,polar=NEG,mood=IND,inter=DECL,tense=PST,per=3,num=PL,aspect={IPFV/PROG}	kullanmıyordular
kullanıyor	pos=V,polar=POS,mood=IND,inter=DECL,tense=PST,per=3,num=PL,aspect=PFV	kullandılar
kurtarmadık	pos=V,polar=POS,mood=IND,inter=DECL,tense=PST,per=3,num=SG,aspect=PFV	kurtardı
kurtarmıyordum	pos=V,polar=NEG,mood=IND,inter=DECL,tense=PRS,per=2,num=SG,aspect={IPFV/PFV}	kurtarmazsın
kurutmadılar	pos=V,polar=POS,mood=IND,inter=DECL,tense=PRS,per=3,num=SG,aspect={IPFV/PFV}	kurutur
kurutmayacaksınız	pos=V,polar=NEG,mood=IND,inter=DECL,tense=PRS,per=3,num=SG,aspect=PROG	kurutmuyor
kurutmaz	pos=V,polar=NEG,mood=IND,inter=DECL,tense=PST,per=3,num=SG,aspect={IPFV/PROG}	kurutmuyordu
kusarız	pos=V,polar=NEG,mood=IND,inter=DECL,tense=PST,per=2,num=PL,aspect=PFV	kusmadınız
küserim	pos=V,polar=NEG,mood=IND,inter=DECL,tense=PST,per=2,num=SG,aspect={IPFV/PROG}	küsmüyordun
kusmadılar	pos=V,polar=NEG,mood=IND,inter=DECL,tense=PRS,per=3,num=PL,aspect=PROG	kusmuyorlar
küsmez	pos=V,polar=POS,mood=IND,inter=DECL,tense=PST,per=1,num=PL,aspect=PFV	küstük
kustun	pos=V,polar=NEG,mood=IND,inter=DECL,tense=PRS,per=1,num=SG,aspect={IPFV/PFV}	kusmam
kustun	pos=V,polar=NEG,mood=IND,inter=DECL,tense=PST,per=3,num=SG,aspect=PFV	kusmadı
küsüyorlar	pos=V,polar=NEG,mood=IND,inter=DECL,tense=PRS,per=2,num=PL,aspect=PROG	küsmüyorsunuz
küsüyorlar	pos=V,polar=NEG,mood=IND,inter=DECL,tense=PST,per=2,num=SG,aspect=PFV	küsmedin
laçoların	pos=N,tense=PRS,per=2,num=PL,aspect={IPFV/PFV}	laçolarsınız
lezbiyeni	pos=N,tense=PRS,per=1,num=SG,aspect={IPFV/PFV}	lezbiyeniz
lunapark	pos=N,tense=PRS,per=3,num=SG,aspect={IPFV/PFV}	lunaparklar
malamozlarınızın	pos=N,tense=PRS,per=3,num=SG,aspect={IPFV/PFV}	malamozlar
mantilerdiniz	pos=N,tense=PRS,per=1,num=SG,aspect={IPFV/PFV}	mantiyiz
maymunlarını	pos=N,tense=PRS,per=1,num=SG,aspect={IPFV/PFV}	maymunuz
metreslerimizde	pos=N,tense=PRS,per=2,num=PL,aspect={IPFV/PFV}	metreslersiniz
mezarlıktılar	pos=N,tense=PRS,per=1,num=PL,aspect={IPFV/PFV}	mezarlıklarız
müezzinler	pos=N,tense=PRS,per=2,num=SG,aspect={IPFV/PFV}	müezzinsiniz
mügelere	pos=N,tense=PRS,per=2,num=PL,aspect={IPFV/PFV}	mügelersiniz
mümessilde	pos=N,tense=PRS,per=2,num=SG,aspect={IPFV/PFV}	mümessilsiniz
mümessilliklerinin	pos=N,tense=PRS,per=3,num=SG,aspect={IPFV/PFV}	mümessillikler
müşterilerinizde	pos=N,tense=PRS,per=2,num=PL,aspect={IPFV/PFV}	müşterilersiniz
nedeninde	pos=N,tense=PRS,per=3,num=SG,aspect={IPFV/PFV}	nedenler
nedeninizi	pos=N,tense=PRS,per=3,num=PL,aspect={IPFV/PFV}	nedenlerdir
nedenlerimiz	pos=N,tense=PRS,per=3,num=SG,aspect={IPFV/PFV}	nedenler
nenelerime	pos=N,tense=PRS,per=1,num=SG,aspect={IPFV/PFV}	neneyiz
ninnilerinize	pos=N,tense=PRS,per=1,num=PL,aspect={IPFV/PFV}	ninnileriz
nohutlar	pos=N,tense=PRS,per=2,num=PL,aspect={IPFV/PFV}	nohutlarsınız
noktaya	pos=N,tense=PRS,per=2,num=SG,aspect={IPFV/PFV}	noktasınız
odacına	pos=N,tense=PRS,per=3,num=SG,aspect={IPFV/PFV}	odacılar
öfkelendireceksiniz	pos=V,polar=POS,mood=IND,inter=DECL,tense=PRS,per=2,num=SG,aspect=PROG	öfkelendiriyorsun
öfkelendireceksin	pos=V,polar=POS,mood=IND,inter=DECL,tense=PRS,per=1,num=PL,aspect={IPFV/PFV}	öfkelendiririz
öfkelendirirsin	pos=V,polar=POS,mood=IND,inter=DECL,tense=PST,per=2,num=SG,aspect=PFV	öfkelendirdin
öfkelendiriyordum	pos=V,polar=POS,mood=IND,inter=DECL,tense=PRS,per=2,num=PL,aspect={IPFV/PFV}	öfkelendirirsiniz
öfkelendirmezsin	pos=V,polar=NEG,mood=IND,inter=DECL,tense=PRS,per=3,num=PL,aspect={IPFV/PFV}	öfkelendirmezler
öfkelendirmiyor	pos=V,polar=NEG,mood=IND,inter=DECL,tense=PRS,per=1,num=SG,aspect={IPFV/PFV}	öfkelendirmem
öğrencisinde	pos=N,tense=PRS,per=1,num=PL,aspect={IPFV/PFV}	öğrencileriz
öğreneceğiz	pos=V,polar=POS,mood=IND,inter=DECL,tense=PRS,per=2,num=PL,aspect={IPFV/PFV}	öğrenirsiniz
öğreneceksiniz	pos=V,polar=POS,mood=IND,inter=DECL,tense=PST,per=2,num=SG,aspect={IPFV/PROG}	öğreniyordun
öğreniyorlar	pos=V,polar=NEG,mood=IND,inter=DECL,tense=PRS,per=2,num=SG,aspect={IPFV/PFV}	öğrenmezsin
öğreniyorlar	pos=V,polar=POS,mood=IND,inter=DECL,tense=PST,per=1,num=SG,aspect={IPFV/PROG}	öğreniyordum
öğreniyorsun	pos=V,polar=POS,mood=IND,inter=DECL,tense=PRS,per=3,num=SG,aspect={IPFV/PFV}	öğrenir
öğreniyorsunuz	pos=V,polar=POS,mood=IND,inter=DECL,tense=PRS,per=2,num=SG,aspect=PROG	öğreniyorsun
öğrenmedi	pos=V,polar=NEG,mood=IND,inter=DECL,tense=PST,per=3,num=SG,aspect={IPFV/PROG}	öğrenmiyordu
öğrenmiyoruz	pos=V,polar=NEG,mood=IND,inter=DECL,tense=PRS,per=1,num=PL,aspect={IPFV/PFV}	öğrenmeyiz
öğreteceğim	pos=V,polar=POS,mood=IND,inter=DECL,tense=PST,per=3,num=SG,aspect={IPFV/PROG}	öğretiyordu
öğretiyorlar	pos=V,polar=POS,mood=IND,inter=DECL,tense=PRS,per=1,num=SG,aspect=PROG	öğretiyorum
öğretmenimi	pos=N,tense=PRS,per=3,num=PL,aspect={IPFV/PFV}	öğretmenlerdir
öğretmenmişiz	pos=N,tense=PRS,per=1,num=PL,aspect={IPFV/PFV}	öğretmenleriz
öğretmiyordular	pos=V,polar=POS,mood=IND,inter=DECL,tense=PST,per=2,num=SG,aspect={IPFV/PROG}	öğretiyordun
öğrettim	pos=V,polar=POS,mood=IND,inter=DECL,tense=PRS,per=3,num=PL,aspect={IPFV/PFV}	öğretirler
öğütmediler	pos=V,polar=NEG,mood=IND,inter=DECL,tense=PRS,per=2,num=PL,aspect={IPFV/PFV}	öğütmezsiniz
öğütmedim	pos=V,polar=POS,mood=IND,inter=DECL,tense=PST,per=3,num=SG,aspect={IPFV/PROG}	öğütüyordu
öğütmediniz	pos=V,polar=NEG,mood=IND,inter=DECL,tense=PST,per=1,num=SG,aspect=PFV	öğütmedim
öğütmedin	pos=V,polar=POS,mood=IND,inter=DECL,tense=PST,per=3,num=SG,aspect={IPFV/PROG}	öğütüyordu
öğütüyorum	pos=V,polar=NEG,mood=IND,inter=DECL,tense=PRS,per=1,num=PL,aspect={IPFV/PFV}	öğütmeyiz
öksürecekler	pos=V,polar=POS,mood=IND,inter=DECL,tense=PST,per=1,num=PL,aspect=PFV	öksürdük
öksüreceksin	pos=V,polar=POS,mood=IND,inter=DECL,tense=PST,per=1,num=PL,aspect=PFV	öksürdük
öksürmediniz	pos=V,polar=NEG,mood=IND,inter=DECL,tense=PRS,per=1,num=SG,aspect=PROG	öksürmüyorum
öksürmeyeceğiz	pos=V,polar=NEG,mood=IND,inter=DECL,tense=PRS,per=2,num=PL,aspect={IPFV/PFV}	öksürmezsiniz
okuduk	pos=V,polar=NEG,mood=IND,inter=DECL,tense=PST,per=2,num=PL,aspect={IPFV/PROG}	okumuyordunuz
okudular	pos=V,polar=NEG,mood=IND,inter=DECL,tense=PST,per=2,num=SG,aspect={IPFV/PROG}	okumuyordun
okumadık	pos=V,polar=NEG,mood=IND,inter=DECL,tense=PRS,per=2,num=SG,aspect=PROG	okumuyorsun
okumadık	pos=V,polar=POS,mood=IND,inter=DECL,tense=PRS,per=2,num=SG,aspect=PROG	okuyorsun
okumazsınız	pos=V,polar=POS,mood=IND,inter=DECL,tense=PST,per=3,num=PL,aspect=PFV	okudular
okumuyorsun	pos=V,polar=POS,mood=IND,inter=DECL,tense=PRS,per=2,num=PL,aspect={IPFV/PFV}	okursunuz
okuyordum	pos=V,polar=NEG,mood=IND,inter=DECL,tense=PRS,per=2,num=SG,aspect=PROG	okumuyorsun
okuyor	pos=V,polar=POS,mood=IND,inter=DECL,tense=PRS,per=1,num=SG,aspect=PROG	okuyorum
ölçecekler	pos=V,polar=NEG,mood=IND,inter=DECL,tense=PST,per=1,num=SG,aspect={IPFV/PROG}	ölçmüyordum
ölçmedik	pos=V,polar=POS,mood=IND,inter=DECL,tense=PST,per=2,num=SG,aspect={IPFV/PROG}	ölçüyordun
ölçmüyordu	pos=V,polar=POS,mood=IND,inter=DECL,tense=PRS,per=1,num=SG,aspect={IPFV/PFV}	ölçerim
ölçmüyorlar	pos=V,polar=NEG,mood=IND,inter=DECL,tense=PST,per=1,num=PL,aspect={IPFV/PROG}	ölçmüyorduk
ölçmüyoruz	pos=V,polar=NEG,mood=IND,inter=DECL,tense=PST,per=3,num=PL,aspect={IPFV/PROG}	ölçmüyordular
ölçtürmeyecek	pos=V,polar=POS,mood=IND,inter=DECL,tense=PST,per=1,num=SG,aspect={IPFV/PROG}	ölçtürüyordum
ölçtürtürsünüz	pos=V,polar=POS,mood=IND,inter=DECL,tense=PST,per=2,num=SG,aspect={IPFV/PROG}	ölçtürtüyordun
ölçtürtürüm	pos=V,polar=POS,mood=IND,inter=DECL,tense=PST,per=3,num=SG,aspect=PFV	ölçtürttü
ölçtürtüyordu	pos=V,polar=NEG,mood=IND,inter=DECL,tense=PST,per=2,num=SG,aspect=PFV	ölçtürtmedin
ölçtürtüyordu	pos=V,polar=POS,mood=IND,inter=DECL,tense=PST,per=1,num=SG,aspect=PFV	ölçtürttüm
ölçtürtüyorsun	pos=V,polar=NEG,mood=IND,inter=DECL,tense=PST,per=3,num=SG,aspect=PFV	ölçtürtmedi
ölçtürtüyorsun	pos=V,polar=POS,mood=IND,inter=DECL,tense=PST,per=1,num=SG,aspect={IPFV/PROG}	ölçtürtüyordum
ölçtürürler	pos=V,polar=NEG,mood=IND,inter=DECL,tense=PST,per=1,num=PL,aspect=PFV	ölçtürmedik
ölçtürüyorsun	pos=V,polar=NEG,mood=IND,inter=DECL,tense=PRS,per=2,num=SG,aspect={IPFV/PFV}	ölçtürmezsin
ölçtürüyorsun	pos=V,polar=POS,mood=IND,inter=DECL,tense=PRS,per=2,num=PL,aspect=PROG	ölçtürüyorsunuz
ölçüldük	pos=V,polar=POS,mood=IND,inter=DECL,tense=PRS,per=3,num=PL,aspect=PROG	ölçülüyorlar
ölçülmezsiniz	pos=V,polar=POS,mood=IND,inter=DECL,tense=PST,per=3,num=SG,aspect=PFV	ölçüldü
ölçülmüyordun	pos=V,polar=NEG,mood=IND,inter=DECL,tense=PST,per=3,num=PL,aspect={IPFV/PROG}	ölçülmüyordular
ölçülmüyorsun	pos=V,polar=NEG,mood=IND,inter=DECL,tense=PST,per=3,num=SG,aspect=PFV	ölçülmedi
ölçülürüm	pos=V,polar=NEG,mood=IND,inter=DECL,tense=PRS,per=2,num=SG,aspect=PROG	ölçülmüyorsun
ölçülüyordu	pos=V,polar=NEG,mood=IND,inter=DECL,tense=PST,per=3,num=SG,aspect={IPFV/PROG}	ölçülmüyordu
ölçülüyoruz	pos=V,polar=NEG,mood=IND,inter=DECL,tense=PRS,per=2,num=PL,aspect={IPFV/PFV}	ölçülmezsiniz
ölçüşecekler	pos=V,polar=NEG,mood=IND,inter=DECL,tense=PST,per=3,num=PL,aspect=PFV	ölçüşmediler
ölçüşmezsiniz	pos=V,polar=NEG,mood=IND,inter=DECL,tense=PRS,per=2,num=SG,aspect=PROG	ölçüşmüyorsun
ölçüşmüyordunuz	pos=V,polar=POS,mood=IND,inter=DECL,tense=PRS,per=1,num=PL,aspect=PROG	ölçüşüyoruz
ölçüşmüyor	pos=V,polar=POS,mood=IND,inter=DECL,tense=PST,per=1,num=SG,aspect={IPFV/PROG}	ölçüşüyordum
ölçüşmüyoruz	pos=V,polar=POS,mood=IND,inter=DECL,tense=PRS,per=2,num=SG,aspect=PROG	ölçüşüyorsun
ölçüştü	pos=V,polar=NEG,mood=IND,inter=DECL,tense=PST,per=1,num=SG,aspect=PFV	ölçüşmedim
ölçüşüyor	pos=V,polar=NEG,mood=IND,inter=DECL,tense=PRS,per=1,num=SG,aspect=PROG	ölçüşmüyorum
oldun	pos=V,polar=POS,mood=IND,inter=DECL,tense=PRS,per=2,num=PL,aspect=PROG	oluyorsunuz
oldun	pos=V,polar=POS,mood=IND,inter=DECL,tense=PST,per=1,num=PL,aspect={IPFV/PROG}	oluyorduk
öldürmem	pos=V,polar=NEG,mood=IND,inter=DECL,tense=PRS,per=3,num=SG,aspect={IPFV/PFV}	öldürmez
öldürtmedi	pos=V,polar=NEG,mood=IND,inter=DECL,tense=PST,per=2,num=SG,aspect=PFV	öldürtmedin
öldürtmeyeceksin	pos=V,polar=NEG,mood=IND,inter=DECL,tense=PRS,per=1,num=SG,aspect=PROG	öldürtmüyorum
öldürttün	pos=V,polar=NEG,mood=IND,inter=DECL,tense=PRS,per=2,num=PL,aspect={IPFV/PFV}	öldürtmezsiniz
öldürtülmedin	pos=V,polar=NEG,mood=IND,inter=DECL,tense=PST,per=3,num=PL,aspect={IPFV/PROG}	öldürtülmüyordular
öldürtülüyorduk	pos=V,polar=POS,mood=IND,inter=DECL,tense=PRS,per=3,num=SG,aspect={IPFV/PFV}	öldürtülür
öldürtülüyorlardı	pos=V,polar=POS,mood=IND,inter=DECL,tense=PRS,per=3,num=SG,aspect={IPFV/PFV}	öldürtülür
öldürtülüyorsunuz	pos=V,polar=NEG,mood=IND,inter=DECL,tense=PRS,per=1,num=PL,aspect=PROG	öldürtülmüyoruz
öldürtülüyorsunuz	pos=V,polar=NEG,mood=IND,inter=DECL,tense=PRS,per=2,num=PL,aspect=PROG	öldürtülmüyorsunuz
öldürtüyoruz	pos=V,polar=POS,mood=IND,inter=DECL,tense=PST,per=1,num=PL,aspect=PFV	öldürttük
öldürüyordun	pos=V,polar=POS,mood=IND,inter=DECL,tense=PST,per=3,num=PL,aspect=PFV	öldürdüler
ölmediniz	pos=V,polar=NEG,mood=IND,inter=DECL,tense=PRS,per=2,num=PL,aspect=PROG	ölmüyorsunuz
ölmeyeceğiz	pos=V,polar=NEG,mood=IND,inter=DECL,tense=PRS,per=3,num=PL,aspect={IPFV/PFV}	ölmezler
ölmeyeceksiniz	pos=V,polar=POS,mood=IND,inter=DECL,tense=PRS,per=1,num=SG,aspect=PROG	ölüyorum
ölmüyoruz	pos=V,polar=NEG,mood=IND,inter=DECL,tense=PST,per=2,num=PL,aspect=PFV	ölmediniz
ölümsüzleştirdin	pos=V,polar=POS,mood=IND,inter=DECL,tense=PST,per=2,num=SG,aspect={IPFV/PROG}	ölümsüzleştiriyordun
ölümsüzleştirecekler	pos=V,polar=POS,mood=IND,inter=DECL,tense=PRS,per=1,num=PL,aspect={IPFV/PFV}	ölümsüzleştiririz
ölümsüzleştiriyordun	pos=V,polar=NEG,mood=IND,inter=DECL,tense=PST,per=2,num=PL,aspect={IPFV/PROG}	ölümsüzleştirmiyordunuz
ölümsüzleştirmeyeceğiz	pos=V,polar=POS,mood=IND,inter=DECL,tense=PST,per=2,num=SG,aspect=PFV	ölümsüzleştirdin
ölümsüzleştirmiyordum	pos=V,polar=POS,mood=IND,inter=DECL,tense=PRS,per=3,num=PL,aspect={IPFV/PFV}	ölümsüzleştirirler
olursunuz	pos=V,polar=POS,mood=IND,inter=DECL,tense=PRS,per=2,num=SG,aspect=PROG	oluyorsun
oluruz	pos=V,polar=NEG,mood=IND,inter=DECL,tense=PRS,per=2,num=SG,aspect=PROG	olmuyorsun
oluyorduk	pos=V,polar=POS,mood=IND,inter=DECL,tense=PRS,per=2,num=SG,aspect={IPFV/PFV}	olursun
ölüyorum	pos=V,polar=NEG,mood=IND,inter=DECL,tense=PRS,per=1,num=SG,aspect={IPFV/PFV}	ölmem
omurganızda	pos=N,tense=PRS,per=1,num=PL,aspect={IPFV/PFV}	omurgalarız
onardık	pos=V,polar=NEG,mood=IND,inter=DECL,tense=PST,per=1,num=SG,aspect=PFV	onarmadım
onarırsın	pos=V,polar=NEG,mood=IND,inter=DECL,tense=PRS,per=2,num=PL,aspect=PROG	onarmıyorsunuz
öpüşecek	pos=V,polar=POS,mood=IND,inter=DECL,tense=PST,per=3,num=SG,aspect=PFV	öpüştü
öpüşmediniz	pos=V,polar=POS,mood=IND,inter=DECL,tense=PRS,per=1,num=SG,aspect=PROG	öpüşüyorum
öpüşmez	pos=V,polar=NEG,mood=IND,inter=DECL,tense=PRS,per=3,num=PL,aspect={IPFV/PFV}	öpüşmezler
öpüşmüyordum	pos=V,polar=NEG,mood=IND,inter=DECL,tense=PRS,per=1,num=PL,aspect={IPFV/PFV}	öpüşmeyiz
öpüşüyorum	pos=V,polar=NEG,mood=IND,inter=DECL,tense=PRS,per=1,num=PL,aspect=PROG	öpüşmüyoruz
öpüyoruz	pos=V,polar=POS,mood=IND,inter=DECL,tense=PST,per=3,num=SG,aspect={IPFV/PROG}	öpüyordu
orospularız	pos=N,tense=PRS,per=2,num=PL,aspect={IPFV/PFV}	orospularsınız
ortağınızda	pos=N,tense=PRS,per=1,num=PL,aspect={IPFV/PFV}	ortaklarız
osururuz	pos=V,polar=POS,mood=IND,inter=DECL,tense=PRS,per=1,num=SG,aspect={IPFV/PFV}	osururum
osuruyorlardı	pos=V,polar=POS,mood=IND,inter=DECL,tense=PRS,per=3,num=PL,aspect=PROG	osuruyorlar
osuruyorsun	pos=V,polar=NEG,mood=IND,inter=DECL,tense=PRS,per=2,num=PL,aspect={IPFV/PFV}	osurmazsınız
osuruyorum	pos=V,polar=POS,mood=IND,inter=DECL,tense=PST,per=2,num=SG,aspect={IPFV/PROG}	osuruyordun
otocularında	pos=N,tense=PRS,per=1,num=PL,aspect={IPFV/PFV}	otocularız
otoculuğumuza	pos=N,tense=PRS,per=2,num=PL,aspect={IPFV/PFV}	otoculuklarsınız
otoculuklarımdan	pos=N,tense=PRS,per=2,num=PL,aspect={IPFV/PFV}	otoculuklarsınız
otoculuktular	pos=N,tense=PRS,per=2,num=SG,aspect={IPFV/PFV}	otoculuksunuz
otomobilcilerinizin	pos=N,tense=PRS,per=2,num=PL,aspect={IPFV/PFV}	otomobilcilersiniz
oturmayacak	pos=V,polar=NEG,mood=IND,inter=DECL,tense=PRS,per=1,num=SG,aspect={IPFV/PFV}	oturmam
oturmayız	pos=V,polar=NEG,mood=IND,inter=DECL,tense=PST,per=2,num=SG,aspect={IPFV/PROG}	oturmuyordun
oturmuyordum	pos=V,polar=POS,mood=IND,inter=DECL,tense=PST,per=3,num=PL,aspect={IPFV/PROG}	oturuyorlardı
oturmuyor	pos=V,polar=POS,mood=IND,inter=DECL,tense=PRS,per=1,num=SG,aspect={IPFV/PFV}	otururum
oturursun	pos=V,polar=POS,mood=IND,inter=DECL,tense=PST,per=3,num=PL,aspect={IPFV/PROG}	oturuyorlardı
otururuz	pos=V,polar=POS,mood=IND,inter=DECL,tense=PRS,per=1,num=PL,aspect=PROG	oturuyoruz
oyalamazsınız	pos=V,polar=POS,mood=IND,inter=DECL,tense=PRS,per=3,num=PL,aspect={IPFV/PFV}	oyalarlar
oyalamazsın	pos=V,polar=POS,mood=IND,inter=DECL,tense=PST,per=1,num=PL,aspect={IPFV/PROG}	oyalıyorduk
oyalamıyordular	pos=V,polar=NEG,mood=IND,inter=DECL,tense=PRS,per=3,num=PL,aspect=PROG	oyalamıyorlar
oyalamıyorsun	pos=V,polar=NEG,mood=IND,inter=DECL,tense=PST,per=1,num=SG,aspect=PFV	oyalamadım
oymaklardan	pos=V,polar=NEG,mood=IND,inter=DECL,tense=PST,per=1,num=SG,aspect=PFV	oymadım
oymaklarım	pos=V,polar=NEG,mood=IND,inter=DECL,tense=PRS,per=3,num=PL,aspect={IPFV/PFV}	oymazlar
oyuyorum	pos=V,polar=POS,mood=IND,inter=DECL,tense=PRS,per=3,num=PL,aspect=PROG	oyuyorlar
palyaçoya	pos=N,tense=PRS,per=1,num=PL,aspect={IPFV/PFV}	palyaçolarız
parçalanacağız	pos=V,polar=NEG,mood=IND,inter=DECL,tense=PRS,per=1,num=SG,aspect=PROG	parçalanmıyorum
parçalandın	pos=V,polar=POS,mood=IND,inter=DECL,tense=PRS,per=3,num=PL,aspect={IPFV/PFV}	parçalanırlar
parçalanır	pos=V,polar=NEG,mood=IND,inter=DECL,tense=PRS,per=1,num=SG,aspect=PROG	parçalanmıyorum
parçalanıyordu	pos=V,polar=POS,mood=IND,inter=DECL,tense=PST,per=1,num=PL,aspect=PFV	parçalandık
parçalanmadın	pos=V,polar=POS,mood=IND,inter=DECL,tense=PRS,per=2,num=SG,aspect={IPFV/PFV}	parçalanırsın
parçalanmayacağız	pos=V,polar=POS,mood=IND,inter=DECL,tense=PRS,per=3,num=PL,aspect={IPFV/PFV}	parçalanırlar
parçalanmazlar	pos=V,polar=NEG,mood=IND,inter=DECL,tense=PST,per=3,num=PL,aspect={IPFV/PROG}	parçalanmıyordular
parçalanmıyordum	pos=V,polar=POS,mood=IND,inter=DECL,tense=PRS,per=3,num=PL,aspect=PROG	parçalanıyorlar
parlatırım	pos=V,polar=NEG,mood=IND,inter=DECL,tense=PRS,per=3,num=PL,aspect=PROG	parlatmıyorlar
parlatırsın	pos=V,polar=POS,mood=IND,inter=DECL,tense=PST,per=1,num=SG,aspect={IPFV/PROG}	parlatıyordum
parlatıyordun	pos=V,polar=POS,mood=IND,inter=DECL,tense=PST,per=1,num=PL,aspect={IPFV/PROG}	parlatıyorduk
parlatıyor	pos=V,polar=POS,mood=IND,inter=DECL,tense=PRS,per=2,num=PL,aspect=PROG	parlatıyorsunuz
parlatmayacaklar	pos=V,polar=POS,mood=IND,inter=DECL,tense=PST,per=2,num=SG,aspect={IPFV/PROG}	parlatıyordun
parlatmazsın	pos=V,polar=POS,mood=IND,inter=DECL,tense=PST,per=2,num=SG,aspect=PFV	parlattın
patlamadım	pos=V,polar=POS,mood=IND,inter=DECL,tense=PRS,per=2,num=SG,aspect={IPFV/PFV}	patlarsın
patlamadınız	pos=V,polar=POS,mood=IND,inter=DECL,tense=PST,per=3,num=SG,aspect=PFV	patladı
patlıyor	pos=V,polar=NEG,mood=IND,inter=DECL,tense=PRS,per=1,num=PL,aspect={IPFV/PFV}	patlamayız
patronları	pos=N,tense=PRS,per=1,num=PL,aspect={IPFV/PFV}	patronlarız
paylaşacağız	pos=V,polar=NEG,mood=IND,inter=DECL,tense=PST,per=3,num=SG,aspect=PFV	paylaşmadı
paylaşmayız	pos=V,polar=POS,mood=IND,inter=DECL,tense=PRS,per=2,num=PL,aspect={IPFV/PFV}	paylaşırsınız
paylaşmıyor	pos=V,polar=NEG,mood=IND,inter=DECL,tense=PST,per=3,num=SG,aspect={IPFV/PROG}	paylaşmıyordu
peçetelerdir	pos=N,tense=PRS,per=2,num=SG,aspect={IPFV/PFV}	peçetesiniz
pimdiler	pos=N,tense=PRS,per=1,num=SG,aspect={IPFV/PFV}	pimiz
pişirecekler	pos=V,polar=POS,mood=IND,inter=DECL,tense=PRS,per=2,num=SG,aspect={IPFV/PFV}	pişirirsin
pişiririm	pos=V,polar=NEG,mood=IND,inter=DECL,tense=PRS,per=2,num=PL,aspect={IPFV/PFV}	pişirmezsiniz
pişirirler	pos=V,polar=POS,mood=IND,inter=DECL,tense=PRS,per=1,num=PL,aspect=PROG	pişiriyoruz
pişirmeyiz	pos=V,polar=POS,mood=IND,inter=DECL,tense=PRS,per=3,num=PL,aspect=PROG	pişiriyorlar
pişirmezler	pos=V,polar=POS,mood=IND,inter=DECL,tense=PST,per=3,num=PL,aspect={IPFV/PROG}	pişiriyorlardı
pişirmiyordular	pos=V,polar=POS,mood=IND,inter=DECL,tense=PRS,per=1,num=SG,aspect={IPFV/PFV}	pişiririm
pişirmiyoruz	pos=V,polar=NEG,mood=IND,inter=DECL,tense=PRS,per=3,num=SG,aspect={IPFV/PFV}	pişirmez
pisletiyordun	pos=V,polar=POS,mood=IND,inter=DECL,tense=PRS,per=1,num=PL,aspect=PROG	pisletiyoruz
pisletiyoruz	pos=V,polar=POS,mood=IND,inter=DECL,tense=PST,per=1,num=SG,aspect={IPFV/PROG}	pisletiyordum
pisletmediler	pos=V,polar=NEG,mood=IND,inter=DECL,tense=PST,per=2,num=PL,aspect={IPFV/PROG}	pisletmiyordunuz
pisletmezsin	pos=V,polar=POS,mood=IND,inter=DECL,tense=PRS,per=1,num=SG,aspect=PROG	pisletiyorum
prenslerdir	pos=N,tense=PRS,per=1,num=SG,aspect={IPFV/PFV}	prensiz
prensmişler	pos=N,tense=PRS,per=2,num=SG,aspect={IPFV/PFV}	prenssiniz
programlanır	pos=V,polar=POS,mood=IND,inter=DECL,tense=PST,per=3,num=SG,aspect=PFV	programlandı
programlanıyorduk	pos=V,polar=NEG,mood=IND,inter=DECL,tense=PRS,per=1,num=PL,aspect={IPFV/PFV}	programlanmayız
programlanıyordunuz	pos=V,polar=NEG,mood=IND,inter=DECL,tense=PST,per=3,num=SG,aspect={IPFV/PROG}	programlanmıyordu
programlanıyorlar	pos=V,polar=POS,mood=IND,inter=DECL,tense=PST,per=3,num=PL,aspect=PFV	programlandılar
programlanmadınız	pos=V,polar=POS,mood=IND,inter=DECL,tense=PST,per=2,num=PL,aspect=PFV	programlandınız
programlanmıyorum	pos=V,polar=NEG,mood=IND,inter=DECL,tense=PRS,per=2,num=SG,aspect={IPFV/PFV}	programlanmazsın
programlatırım	pos=V,polar=POS,mood=IND,inter=DECL,tense=PST,per=2,num=PL,aspect=PFV	programlattınız
programlatmadın	pos=V,polar=POS,mood=IND,inter=DECL,tense=PRS,per=3,num=PL,aspect=PROG	programlatıyorlar
programlatmayacaksın	pos=V,polar=POS,mood=IND,inter=DECL,tense=PST,per=2,num=SG,aspect=PFV	programlattın
programlattırdık	pos=V,polar=NEG,mood=IND,inter=DECL,tense=PRS,per=2,num=SG,aspect={IPFV/PFV}	programlattırmazsın
programlattırdık	pos=V,polar=NEG,mood=IND,inter=DECL,tense=PRS,per=3,num=SG,aspect=PROG	programlattırmıyor
programlattırdılar	pos=V,polar=POS,mood=IND,inter=DECL,tense=PRS,per=1,num=PL,aspect={IPFV/PFV}	programlattırırız
programlattırırım	pos=V,polar=POS,mood=IND,inter=DECL,tense=PRS,per=2,num=PL,aspect={IPFV/PFV}	programlattırırsınız
programlattırıyor	pos=V,polar=POS,mood=IND,inter=DECL,tense=PRS,per=2,num=PL,aspect={IPFV/PFV}	programlattırırsınız
programlattırıyorsun	pos=V,polar=POS,mood=IND,inter=DECL,tense=PRS,per=2,num=PL,aspect={IPFV/PFV}	programlattırırsınız
pusulalar	pos=N,tense=PRS,per=3,num=PL,aspect={IPFV/PFV}	pusulalardır
rahatsızlanacaksınız	pos=V,polar=POS,mood=IND,inter=DECL,tense=PST,per=1,num=PL,aspect={IPFV/PROG}	rahatsızlanıyorduk
rahatsızlanırız	pos=V,polar=POS,mood=IND,inter=DECL,tense=PRS,per=3,num=PL,aspect={IPFV/PFV}	rahatsızlanırlar
rahatsızlanmayız	pos=V,polar=NEG,mood=IND,inter=DECL,tense=PST,per=3,num=PL,aspect={IPFV/PROG}	rahatsızlanmıyordular
rubailerinizde	pos=N,tense=PRS,per=1,num=PL,aspect={IPFV/PFV}	rubaileriz
sağlarınızı	pos=N,tense=PRS,per=1,num=PL,aspect={IPFV/PFV}	sağlarız
sağlayıcımız	pos=N,tense=PRS,per=2,num=PL,aspect={IPFV/PFV}	sağlayıcılarsınız
saklanacaklar	pos=V,polar=POS,mood=IND,inter=DECL,tense=PST,per=1,num=SG,aspect=PFV	saklandım
saklandık	pos=V,polar=NEG,mood=IND,inter=DECL,tense=PST,per=2,num=SG,aspect={IPFV/PROG}	saklanmıyordun
saklandım	pos=V,polar=POS,mood=IND,inter=DECL,tense=PRS,per=3,num=PL,aspect=PROG	saklanıyorlar
saklanıyordum	pos=V,polar=NEG,mood=IND,inter=DECL,tense=PST,per=1,num=SG,aspect={IPFV/PROG}	saklanmıyordum
saklanıyorlar	pos=V,polar=POS,mood=IND,inter=DECL,tense=PRS,per=1,num=PL,aspect=PROG	saklanıyoruz
saklanıyorsun	pos=V,polar=POS,mood=IND,inter=DECL,tense=PRS,per=1,num=SG,aspect={IPFV/PFV}	saklanırım
saklanmadım	pos=V,polar=POS,mood=IND,inter=DECL,tense=PST,per=1,num=PL,aspect={IPFV/PROG}	saklanıyorduk
saklanmayacağız	pos=V,polar=NEG,mood=IND,inter=DECL,tense=PRS,per=2,num=PL,aspect={IPFV/PFV}	saklanmazsınız
saklanmazsın	pos=V,polar=NEG,mood=IND,inter=DECL,tense=PST,per=1,num=PL,aspect={IPFV/PROG}	saklanmıyorduk
salatamda	pos=N,tense=PRS,per=3,num=PL,aspect={IPFV/PFV}	salatalardır
saldıracak	pos=V,polar=NEG,mood=IND,inter=DECL,tense=PRS,per=1,num=SG,aspect=PROG	saldırmıyorum
saldırırım	pos=V,polar=NEG,mood=IND,inter=DECL,tense=PST,per=2,num=PL,aspect={IPFV/PROG}	saldırmıyordunuz
saldırırız	pos=V,polar=POS,mood=IND,inter=DECL,tense=PRS,per=2,num=PL,aspect=PROG	saldırıyorsunuz
saldırıyorsun	pos=V,polar=NEG,mood=IND,inter=DECL,tense=PRS,per=1,num=PL,aspect=PROG	saldırmıyoruz
saldırmadı	pos=V,polar=NEG,mood=IND,inter=DECL,tense=PRS,per=3,num=PL,aspect=PROG	saldırmıyorlar
saldırmayacaklar	pos=V,polar=POS,mood=IND,inter=DECL,tense=PRS,per=1,num=PL,aspect=PROG	saldırıyoruz
saldırmaz	pos=V,polar=POS,mood=IND,inter=DECL,tense=PRS,per=1,num=SG,aspect={IPFV/PFV}	saldırırım
şamarlamazlar	pos=V,polar=NEG,mood=IND,inter=DECL,tense=PRS,per=1,num=PL,aspect=PROG	şamarlamıyoruz
şamarlamıyordum	pos=V,polar=POS,mood=IND,inter=DECL,tense=PST,per=2,num=SG,aspect=PFV	şamarladın
şamarlayacağım	pos=V,polar=NEG,mood=IND,inter=DECL,tense=PST,per=1,num=PL,aspect=PFV	şamarlamadık
şamarlıyor	pos=V,polar=NEG,mood=IND,inter=DECL,tense=PST,per=1,num=PL,aspect={IPFV/PROG}	şamarlamıyorduk
sanmadı	pos=V,polar=POS,mood=IND,inter=DECL,tense=PRS,per=3,num=SG,aspect=PROG	sanıyor
sanmayacağım	pos=V,polar=POS,mood=IND,inter=DECL,tense=PST,per=2,num=PL,aspect={IPFV/PROG}	sanıyordunuz
sanmıyordu	pos=V,polar=NEG,mood=IND,inter=DECL,tense=PST,per=1,num=PL,aspect={IPFV/PROG}	sanmıyorduk
sanmıyorlar	pos=V,polar=POS,mood=IND,inter=DECL,tense=PRS,per=1,num=SG,aspect={IPFV/PFV}	sanırım
sapanlarımın	pos=N,tense=PRS,per=1,num=SG,aspect={IPFV/PFV}	sapanız
şapkacılardınız	pos=N,tense=PRS,per=3,num=SG,aspect={IPFV/PFV}	şapkacılar
şapkacına	pos=N,tense=PRS,per=1,num=PL,aspect={IPFV/PFV}	şapkacılarız
sararırsınız	pos=V,polar=NEG,mood=IND,inter=DECL,tense=PRS,per=3,num=SG,aspect={IPFV/PFV}	sararmaz
sararıyordum	pos=V,polar=POS,mood=IND,inter=DECL,tense=PST,per=3,num=SG,aspect={IPFV/PROG}	sararıyordu
sararıyordunuz	pos=V,polar=NEG,mood=IND,inter=DECL,tense=PST,per=2,num=SG,aspect=PFV	sararmadın
sararmadım	pos=V,polar=NEG,mood=IND,inter=DECL,tense=PRS,per=1,num=PL,aspect={IPFV/PFV}	sararmayız
sararmayacaksınız	pos=V,polar=NEG,mood=IND,inter=DECL,tense=PST,per=2,num=PL,aspect=PFV	sararmadınız
sarılarmış	pos=N,tense=PRS,per=3,num=PL,aspect={IPFV/PFV}	sarılardır
sarıldınız	pos=V,polar=NEG,mood=IND,inter=DECL,tense=PRS,per=3,num=SG,aspect={IPFV/PFV}	sarılmaz
sarılırız	pos=V,polar=POS,mood=IND,inter=DECL,tense=PRS,per=1,num=SG,aspect={IPFV/PFV}	sarılırım
sarılıyordu	pos=V,polar=POS,mood=IND,inter=DECL,tense=PST,per=1,num=PL,aspect={IPFV/PROG}	sarılıyorduk
sarılıyoruz	pos=V,polar=NEG,mood=IND,inter=DECL,tense=PRS,per=1,num=SG,aspect={IPFV/PFV}	sarılmam
sarılmadın	pos=V,polar=NEG,mood=IND,inter=DECL,tense=PST,per=2,num=SG,aspect={IPFV/PROG}	sarılmıyordun
sarılmayacaksınız	pos=V,polar=NEG,mood=IND,inter=DECL,tense=PRS,per=2,num=PL,aspect={IPFV/PFV}	sarılmazsınız
sarılmayacaksın	pos=V,polar=NEG,mood=IND,inter=DECL,tense=PST,per=1,num=PL,aspect=PFV	sarılmadık
sarılmayacaksın	pos=V,polar=POS,mood=IND,inter=DECL,tense=PST,per=2,num=PL,aspect={IPFV/PROG}	sarılıyordunuz
şarkıcıyız	pos=N,tense=PRS,per=2,num=PL,aspect={IPFV/PFV}	şarkıcılarsınız
şaşacağım	pos=V,polar=NEG,mood=IND,inter=DECL,tense=PST,per=1,num=SG,aspect={IPFV/PROG}	şaşmıyordum
şaşılacağım	pos=V,polar=NEG,mood=IND,inter=DECL,tense=PRS,per=3,num=SG,aspect={IPFV/PFV}	şaşılmaz
şaşılıyorlar	pos=V,polar=POS,mood=IND,inter=DECL,tense=PRS,per=3,num=SG,aspect={IPFV/PFV}	şaşılır
şaşılmazsın	pos=V,polar=NEG,mood=IND,inter=DECL,tense=PRS,per=1,num=PL,aspect={IPFV/PFV}	şaşılmayız
şaşılmıyorlar	pos=V,polar=NEG,mood=IND,inter=DECL,tense=PST,per=2,num=PL,aspect=PFV	şaşılmadınız
şaşılmıyorsun	pos=V,polar=POS,mood=IND,inter=DECL,tense=PRS,per=1,num=SG,aspect={IPFV/PFV}	şaşılırım
şaşırır	pos=V,polar=POS,mood=IND,inter=DECL,tense=PRS,per=1,num=PL,aspect=PROG	şaşırıyoruz
şaşırır	pos=V,polar=POS,mood=IND,inter=DECL,tense=PRS,per=3,num=SG,aspect=PROG	şaşırıyor
şaşırıyordum	pos=V,polar=NEG,mood=IND,inter=DECL,tense=PRS,per=2,num=PL,aspect=PROG	şaşırmıyorsunuz
şaşırıyorlardı	pos=V,polar=NEG,mood=IND,inter=DECL,tense=PRS,per=3,num=SG,aspect=PROG	şaşırmıyor
şaşırıyorsunuz	pos=V,polar=NEG,mood=IND,inter=DECL,tense=PRS,per=2,num=SG,aspect={IPFV/PFV}	şaşırmazsın
şaşırmayacak	pos=V,polar=NEG,mood=IND,inter=DECL,tense=PST,per=2,num=SG,aspect=PFV	şaşırmadın
şaşırmayacaksınız	pos=V,polar=POS,mood=IND,inter=DECL,tense=PRS,per=1,num=SG,aspect={IPFV/PFV}	şaşırırım
şaşırmayacaksın	pos=V,polar=NEG,mood=IND,inter=DECL,tense=PRS,per=1,num=SG,aspect={IPFV/PFV}	şaşırmam
şaşırmıyorlar	pos=V,polar=POS,mood=IND,inter=DECL,tense=PRS,per=2,num=PL,aspect=PROG	şaşırıyorsunuz
şaşır	pos=V,polar=POS,mood=IND,inter=DECL,tense=PST,per=2,num=SG,aspect={IPFV/PROG}	şaşıyordun
şaşırtdı	pos=V,polar=NEG,mood=IND,inter=DECL,tense=PRS,per=3,num=PL,aspect={IPFV/PFV}	şaşırtmazlar
şaşırtmadınız	pos=V,polar=POS,mood=IND,inter=DECL,tense=PRS,per=2,num=SG,aspect=PROG	şaşırtıyorsun
şaşırtmayacağım	pos=V,polar=POS,mood=IND,inter=DECL,tense=PRS,per=3,num=SG,aspect=PROG	şaşırtıyor
şaşırtmıyordu	pos=V,polar=NEG,mood=IND,inter=DECL,tense=PRS,per=1,num=SG,aspect={IPFV/PFV}	şaşırtmam
şaşırttıracaksın	pos=V,polar=NEG,mood=IND,inter=DECL,tense=PRS,per=2,num=SG,aspect=PROG	şaşırttırmıyorsun
şaşırttırırsınız	pos=V,polar=POS,mood=IND,inter=DECL,tense=PRS,per=2,num=PL,aspect=PROG	şaşırttırıyorsunuz
şaşırttırırsın	pos=V,polar=POS,mood=IND,inter=DECL,tense=PRS,per=1,num=PL,aspect={IPFV/PFV}	şaşırttırırız
şaşırttırırsın	pos=V,polar=POS,mood=IND,inter=DECL,tense=PST,per=3,num=PL,aspect={IPFV/PROG}	şaşırttırıyorlardı
şaşırttırıyordu	pos=V,polar=POS,mood=IND,inter=DECL,tense=PST,per=1,num=SG,aspect={IPFV/PROG}	şaşırttırıyordum
şaşırttırtık	pos=V,polar=POS,mood=IND,inter=DECL,tense=PRS,per=2,num=PL,aspect={IPFV/PFV}	şaşırttırırsınız
şaşıyorsun	pos=V,polar=NEG,mood=IND,inter=DECL,tense=PRS,per=3,num=SG,aspect=PROG	şaşmıyor
şaşmadık	pos=V,polar=NEG,mood=IND,inter=DECL,tense=PST,per=2,num=SG,aspect={IPFV/PROG}	şaşmıyordun
şaşmıyordu	pos=V,polar=NEG,mood=IND,inter=DECL,tense=PRS,per=1,num=PL,aspect=PROG	şaşmıyoruz
şaşmıyorum	pos=V,polar=NEG,mood=IND,inter=DECL,tense=PST,per=2,num=SG,aspect=PFV	şaşmadın
satacak	pos=V,polar=POS,mood=IND,inter=DECL,tense=PST,per=3,num=PL,aspect={IPFV/PROG}	satıyorlardı
satılacaksın	pos=V,polar=POS,mood=IND,inter=DECL,tense=PST,per=3,num=PL,aspect=PFV	satıldılar
satıldın	pos=V,polar=NEG,mood=IND,inter=DECL,tense=PRS,per=3,num=PL,aspect=PROG	satılmıyorlar
satılıyordun	pos=V,polar=POS,mood=IND,inter=DECL,tense=PST,per=1,num=SG,aspect=PFV	satıldım
satılıyorlardı	pos=V,polar=POS,mood=IND,inter=DECL,tense=PRS,per=2,num=SG,aspect=PROG	satılıyorsun
satılıyorsun	pos=V,polar=POS,mood=IND,inter=DECL,tense=PST,per=1,num=SG,aspect=PFV	satıldım
satılmayacaksın	pos=V,polar=NEG,mood=IND,inter=DECL,tense=PRS,per=1,num=SG,aspect=PROG	satılmıyorum
satılmıyorsun	pos=V,polar=POS,mood=IND,inter=DECL,tense=PRS,per=1,num=PL,aspect={IPFV/PFV}	satılırız
satırtıyordum	pos=V,polar=NEG,mood=IND,inter=DECL,tense=PST,per=2,num=SG,aspect=PFV	satırtmadın
satırtıyordun	pos=V,polar=NEG,mood=IND,inter=DECL,tense=PRS,per=1,num=SG,aspect=PROG	satırtmıyorum
satırtmıyordum	pos=V,polar=NEG,mood=IND,inter=DECL,tense=PRS,per=1,num=SG,aspect=PROG	satırtmıyorum
satırttım	pos=V,polar=POS,mood=IND,inter=DECL,tense=PRS,per=3,num=PL,aspect={IPFV/PFV}	sattırırlar
satırttınız	pos=V,polar=NEG,mood=IND,inter=DECL,tense=PRS,per=3,num=SG,aspect=PROG	satırtmıyor
satırttı	pos=V,polar=NEG,mood=IND,inter=DECL,tense=PRS,per=1,num=PL,aspect=PROG	satırtmıyoruz
satırttı	pos=V,polar=POS,mood=IND,inter=DECL,tense=PST,per=2,num=SG,aspect=PFV	satırttın
satmayacağım	pos=V,polar=POS,mood=IND,inter=DECL,tense=PRS,per=2,num=PL,aspect={IPFV/PFV}	satarsınız
satmayacaksınız	pos=V,polar=POS,mood=IND,inter=DECL,tense=PRS,per=3,num=SG,aspect={IPFV/PFV}	satar
satmıyorduk	pos=V,polar=NEG,mood=IND,inter=DECL,tense=PST,per=2,num=PL,aspect={IPFV/PROG}	satmıyordunuz
sattırtıracağız	pos=V,polar=POS,mood=IND,inter=DECL,tense=PST,per=3,num=SG,aspect=PFV	sattırtırdı
sattırtırıyordum	pos=V,polar=POS,mood=IND,inter=DECL,tense=PRS,per=1,num=SG,aspect={IPFV/PFV}	sattırtırım
sattırtırmadın	pos=V,polar=POS,mood=IND,inter=DECL,tense=PST,per=1,num=PL,aspect={IPFV/PROG}	sattırtırıyorduk
sattırtırmadı	pos=V,polar=POS,mood=IND,inter=DECL,tense=PRS,per=3,num=SG,aspect=PROG	sattırtırıyor
sattırtırmayacaklar	pos=V,polar=NEG,mood=IND,inter=DECL,tense=PST,per=2,num=PL,aspect=PFV	sattırtırmadınız
sattırtırmayacaksınız	pos=V,polar=POS,mood=IND,inter=DECL,tense=PST,per=3,num=PL,aspect=PFV	sattırtırdılar
sattırtırmıyordunuz	pos=V,polar=NEG,mood=IND,inter=DECL,tense=PRS,per=2,num=PL,aspect={IPFV/PFV}	sattırtırmazsınız
sayacağım	pos=V,polar=NEG,mood=IND,inter=DECL,tense=PRS,per=2,num=SG,aspect=PROG	saymıyorsun
saydılar	pos=V,polar=POS,mood=IND,inter=DECL,tense=PRS,per=2,num=SG,aspect={IPFV/PFV}	sayarsın
saydırmazlar	pos=V,polar=POS,mood=IND,inter=DECL,tense=PRS,per=2,num=PL,aspect={IPFV/PFV}	saydırırsınız
saydırmaz	pos=V,polar=NEG,mood=IND,inter=DECL,tense=PST,per=3,num=SG,aspect={IPFV/PROG}	saydırmıyordu
saydırmıyorduk	pos=V,polar=NEG,mood=IND,inter=DECL,tense=PST,per=2,num=SG,aspect={IPFV/PROG}	saydırmıyordun
saydırtırım	pos=V,polar=NEG,mood=IND,inter=DECL,tense=PST,per=3,num=SG,aspect=PFV	saydırtmadı
saydırtırsın	pos=V,polar=POS,mood=IND,inter=DECL,tense=PRS,per=1,num=SG,aspect=PROG	saydırtıyorum
saydırtıyorlardı	pos=V,polar=POS,mood=IND,inter=DECL,tense=PST,per=3,num=SG,aspect=PFV	saydırttı
saydırtıyorum	pos=V,polar=NEG,mood=IND,inter=DECL,tense=PRS,per=2,num=PL,aspect={IPFV/PFV}	saydırtmazsınız
saydırtmayız	pos=V,polar=POS,mood=IND,inter=DECL,tense=PST,per=2,num=PL,aspect={IPFV/PROG}	saydırtıyordunuz
saydırtmıyorsun	pos=V,polar=NEG,mood=IND,inter=DECL,tense=PST,per=2,num=SG,aspect=PFV	saydırtmadın
saydırttık	pos=V,polar=NEG,mood=IND,inter=DECL,tense=PRS,per=3,num=PL,aspect={IPFV/PFV}	saydırtmazlar
sayfamı	pos=N,tense=PRS,per=1,num=SG,aspect={IPFV/PFV}	sayfayız
sayıyor	pos=V,polar=POS,mood=IND,inter=DECL,tense=PST,per=2,num=PL,aspect=PFV	saydınız
sayıyorsun	pos=V,polar=NEG,mood=IND,inter=DECL,tense=PST,per=2,num=PL,aspect=PFV	saymadınız
saymıyordular	pos=V,polar=POS,mood=IND,inter=DECL,tense=PRS,per=1,num=SG,aspect={IPFV/PFV}	sayarım
saymıyorsun	pos=V,polar=POS,mood=IND,inter=DECL,tense=PST,per=3,num=PL,aspect={IPFV/PROG}	sayıyorlardı
seçerim	pos=V,polar=POS,mood=IND,inter=DECL,tense=PRS,per=3,num=PL,aspect={IPFV/PFV}	seçerler
seçilmem	pos=V,polar=POS,mood=IND,inter=DECL,tense=PST,per=2,num=SG,aspect=PFV	seçildin
seçilmezler	pos=V,polar=POS,mood=IND,inter=DECL,tense=PRS,per=1,num=SG,aspect=PROG	seçiliyorum
seçilmiyordu	pos=V,polar=NEG,mood=IND,inter=DECL,tense=PST,per=1,num=PL,aspect=PFV	seçilmedik
seçilmiyordu	pos=V,polar=NEG,mood=IND,inter=DECL,tense=PST,per=2,num=SG,aspect={IPFV/PROG}	seçilmiyordun
seçilmiyoruz	pos=V,polar=POS,mood=IND,inter=DECL,tense=PST,per=3,num=PL,aspect=PFV	seçildiler
seçiyordum	pos=V,polar=POS,mood=IND,inter=DECL,tense=PST,per=1,num=SG,aspect=PFV	seçtim
seçmediler	pos=V,polar=NEG,mood=IND,inter=DECL,tense=PRS,per=3,num=SG,aspect=PROG	seçmiyor
seçmedim	pos=V,polar=NEG,mood=IND,inter=DECL,tense=PRS,per=3,num=PL,aspect={IPFV/PFV}	seçmezler
seçmedin	pos=V,polar=POS,mood=IND,inter=DECL,tense=PRS,per=2,num=PL,aspect={IPFV/PFV}	seçersiniz
seçmenimize	pos=N,tense=PRS,per=2,num=PL,aspect={IPFV/PFV}	seçmenlersiniz
seçtiniz	pos=V,polar=POS,mood=IND,inter=DECL,tense=PRS,per=1,num=SG,aspect={IPFV/PFV}	seçerim
semercilerimden	pos=N,tense=PRS,per=1,num=PL,aspect={IPFV/PFV}	semercileriz
şemsiyelerdi	pos=N,tense=PRS,per=3,num=PL,aspect={IPFV/PFV}	şemsiyelerdir
şemsiyelerimden	pos=N,tense=PRS,per=3,num=PL,aspect={IPFV/PFV}	şemsiyelerdir
seslenirim	pos=V,polar=NEG,mood=IND,inter=DECL,tense=PRS,per=2,num=PL,aspect=PROG	seslenmiyorsunuz
seslenirsiniz	pos=V,polar=POS,mood=IND,inter=DECL,tense=PST,per=1,num=SG,aspect=PFV	seslendim
seslenmedim	pos=V,polar=NEG,mood=IND,inter=DECL,tense=PRS,per=3,num=SG,aspect=PROG	seslenmiyor
seslermişiz	pos=N,tense=PRS,per=1,num=PL,aspect={IPFV/PFV}	sesleriz
seyretmediniz	pos=V,polar=NEG,mood=IND,inter=DECL,tense=PRS,per=1,num=SG,aspect=PROG	seyretmiyorum
seyretmiyordum	pos=V,polar=NEG,mood=IND,inter=DECL,tense=PRS,per=3,num=PL,aspect=PROG	seyretmiyorlar
seyretmiyorum	pos=V,polar=POS,mood=IND,inter=DECL,tense=PRS,per=3,num=PL,aspect={IPFV/PFV}	seyretirler
sıçanınızın	pos=N,tense=PRS,per=3,num=PL,aspect={IPFV/PFV}	sıçanlardır
sıçanlarımdan	pos=N,tense=PRS,per=3,num=PL,aspect={IPFV/PFV}	sıçanlardır
sıçanlarını	pos=N,tense=PRS,per=1,num=SG,aspect={IPFV/PFV}	sıçanız
sıçarız	pos=V,polar=POS,mood=IND,inter=DECL,tense=PRS,per=2,num=SG,aspect={IPFV/PFV}	sıçarsın
sıçmayacak	pos=V,polar=NEG,mood=IND,inter=DECL,tense=PST,per=1,num=SG,aspect=PFV	sıçmadım
sikilecekler	pos=V,polar=POS,mood=IND,inter=DECL,tense=PRS,per=3,num=SG,aspect=PROG	sikiliyor
sikiliyordu	pos=V,polar=NEG,mood=IND,inter=DECL,tense=PRS,per=3,num=PL,aspect={IPFV/PFV}	sikilmezler
sikilmeyeceğiz	pos=V,polar=NEG,mood=IND,inter=DECL,tense=PRS,per=1,num=PL,aspect=PROG	sikilmiyoruz
sikilmeyeceksiniz	pos=V,polar=POS,mood=IND,inter=DECL,tense=PRS,per=1,num=SG,aspect=PROG	sikiliyorum
sikilmezsin	pos=V,polar=POS,mood=IND,inter=DECL,tense=PST,per=1,num=SG,aspect=PFV	sikildim
sikişirsiniz	pos=V,polar=NEG,mood=IND,inter=DECL,tense=PRS,per=2,num=SG,aspect={IPFV/PFV}	sikişmezsin
sikişmeyeceğiz	pos=V,polar=NEG,mood=IND,inter=DECL,tense=PRS,per=2,num=SG,aspect={IPFV/PFV}	sikişmezsin
sikişmiyordum	pos=V,polar=POS,mood=IND,inter=DECL,tense=PST,per=3,num=PL,aspect={IPFV/PROG}	sikişiyorlardı
sikişmiyorlar	pos=V,polar=NEG,mood=IND,inter=DECL,tense=PRS,per=3,num=SG,aspect={IPFV/PFV}	sikişmez
sikişmiyoruz	pos=V,polar=NEG,mood=IND,inter=DECL,tense=PST,per=2,num=SG,aspect=PFV	sikişmedin
sıkmayacağım	pos=V,polar=POS,mood=IND,inter=DECL,tense=PRS,per=1,num=PL,aspect={IPFV/PFV}	sıkarız
sıkmaz	pos=V,polar=POS,mood=IND,inter=DECL,tense=PST,per=1,num=PL,aspect={IPFV/PROG}	sıkıyorduk
sikmiyordu	pos=V,polar=NEG,mood=IND,inter=DECL,tense=PST,per=1,num=PL,aspect={IPFV/PROG}	sikmiyorduk
sıkmıyorlar	pos=V,polar=NEG,mood=IND,inter=DECL,tense=PST,per=3,num=SG,aspect={IPFV/PROG}	sıkmıyordu
sıktım	pos=V,polar=NEG,mood=IND,inter=DECL,tense=PST,per=3,num=PL,aspect=PFV	sıkmadılar
sildim	pos=V,polar=NEG,mood=IND,inter=DECL,tense=PRS,per=1,num=SG,aspect=PROG	silmiyorum
silecekler	pos=V,polar=NEG,mood=IND,inter=DECL,tense=PST,per=3,num=PL,aspect={IPFV/PROG}	silmiyordular
silginde	pos=N,tense=PRS,per=2,num=PL,aspect={IPFV/PFV}	silgilersiniz
siliyordum	pos=V,polar=NEG,mood=IND,inter=DECL,tense=PST,per=2,num=PL,aspect={IPFV/PROG}	silmiyordunuz
siliyordum	pos=V,polar=NEG,mood=IND,inter=DECL,tense=PST,per=3,num=PL,aspect=PFV	silmediler
siliyordun	pos=V,polar=POS,mood=IND,inter=DECL,tense=PST,per=1,num=SG,aspect=PFV	sildim
silmiyordunuz	pos=V,polar=POS,mood=IND,inter=DECL,tense=PRS,per=2,num=SG,aspect=PROG	siliyorsun
sindiriyorsun	pos=V,polar=POS,mood=IND,inter=DECL,tense=PRS,per=3,num=PL,aspect=PROG	sindiriyorlar
sindirmiyor	pos=V,polar=POS,mood=IND,inter=DECL,tense=PRS,per=3,num=SG,aspect={IPFV/PFV}	sindirir
sindirmiyorum	pos=V,polar=NEG,mood=IND,inter=DECL,tense=PST,per=2,num=SG,aspect=PFV	sindirmedin
sineğine	pos=N,tense=PRS,per=2,num=SG,aspect={IPFV/PFV}	sineksiniz
sinektiler	pos=N,tense=PRS,per=3,num=PL,aspect={IPFV/PFV}	sineklerdir
sinirlendirdim	pos=V,polar=NEG,mood=IND,inter=DECL,tense=PRS,per=1,num=SG,aspect={IPFV/PFV}	sinirlendirmem
sinirlendirdin	pos=V,polar=NEG,mood=IND,inter=DECL,tense=PRS,per=1,num=SG,aspect=PROG	sinirlendirmiyorum
sinirlendiririm	pos=V,polar=POS,mood=IND,inter=DECL,tense=PRS,per=3,num=PL,aspect={IPFV/PFV}	sinirlendirirler
sinirlendirmiyorduk	pos=V,polar=POS,mood=IND,inter=DECL,tense=PRS,per=1,num=SG,aspect=PROG	sinirlendiriyorum
sinirlendirmiyoruz	pos=V,polar=NEG,mood=IND,inter=DECL,tense=PST,per=1,num=SG,aspect={IPFV/PROG}	sinirlendirmiyordum
sıraladık	pos=V,tense=PST,per=3,num=PL,aspect={IPFV/PROG}	sıralıyorlardı
sıralarız	pos=V,tense=PRS,per=1,num=SG,aspect=PROG	sıralıyorum
sıralatırım	pos=V,tense=PRS,per=2,num=SG,aspect={IPFV/PFV}	sıralatırsın
sıralatıyorduk	pos=V,tense=PST,per=3,num=PL,aspect={IPFV/PROG}	sıralatıyorlardı
sıralıyor	pos=V,tense=PST,per=1,num=PL,aspect={IPFV/PROG}	sıralıyorduk
sonuçlarmışız	pos=N,tense=PRS,per=1,num=SG,aspect={IPFV/PFV}	sonucuz
sonucumuza	pos=N,tense=PRS,per=2,num=SG,aspect={IPFV/PFV}	sonuçsunuz
sorduk	pos=V,polar=POS,mood=IND,inter=DECL,tense=PRS,per=3,num=SG,aspect=PROG	soruyor
sordular	pos=V,polar=NEG,mood=IND,inter=DECL,tense=PRS,per=2,num=SG,aspect={IPFV/PFV}	sormazsın
sordu	pos=V,polar=NEG,mood=IND,inter=DECL,tense=PST,per=3,num=SG,aspect={IPFV/PROG}	sormuyordu
sormadık	pos=V,polar=NEG,mood=IND,inter=DECL,tense=PST,per=3,num=PL,aspect={IPFV/PROG}	sormuyordular
sormayacağım	pos=V,polar=POS,mood=IND,inter=DECL,tense=PST,per=2,num=SG,aspect={IPFV/PROG}	soruyordun
sormayacaklar	pos=V,polar=POS,mood=IND,inter=DECL,tense=PST,per=2,num=SG,aspect=PFV	sordun
sormuyordun	pos=V,polar=NEG,mood=IND,inter=DECL,tense=PST,per=3,num=SG,aspect=PFV	sormadı
soruyorlardı	pos=V,polar=POS,mood=IND,inter=DECL,tense=PST,per=2,num=PL,aspect=PFV	sordunuz
soruyorum	pos=V,polar=NEG,mood=IND,inter=DECL,tense=PRS,per=3,num=SG,aspect={IPFV/PFV}	sormaz
söylemem	pos=V,polar=POS,mood=IND,inter=DECL,tense=PRS,per=3,num=PL,aspect=PROG	söylüyorlar
söyleriz	pos=V,polar=POS,mood=IND,inter=DECL,tense=PST,per=1,num=SG,aspect={IPFV/PROG}	söylüyordum
sözlerinizi	pos=N,tense=PRS,per=2,num=PL,aspect={IPFV/PFV}	sözlersiniz
sultanmışlar	pos=N,tense=PRS,per=2,num=PL,aspect={IPFV/PFV}	sultanlarsınız
sunacak	pos=V,polar=NEG,mood=IND,inter=DECL,tense=PRS,per=1,num=SG,aspect={IPFV/PFV}	sunmam
sunmadı	pos=V,polar=NEG,mood=IND,inter=DECL,tense=PST,per=2,num=SG,aspect={IPFV/PROG}	sunmuyordun
sunmayacak	pos=V,polar=POS,mood=IND,inter=DECL,tense=PST,per=3,num=SG,aspect={IPFV/PROG}	sunuyordu
sunmayacaksınız	pos=V,polar=NEG,mood=IND,inter=DECL,tense=PST,per=2,num=PL,aspect=PFV	sunmadınız
sunulmadı	pos=V,polar=POS,mood=IND,inter=DECL,tense=PST,per=3,num=SG,aspect={IPFV/PROG}	sunuluyordu
süpürmeyecekler	pos=V,polar=POS,mood=IND,inter=DECL,tense=PRS,per=1,num=PL,aspect={IPFV/PFV}	süpürürüz
süpürmüyorduk	pos=V,polar=POS,mood=IND,inter=DECL,tense=PRS,per=1,num=SG,aspect=PROG	süpürüyorum
süpürmüyordular	pos=V,polar=POS,mood=IND,inter=DECL,tense=PRS,per=3,num=SG,aspect=PROG	süpürüyor
süpürürler	pos=V,polar=POS,mood=IND,inter=DECL,tense=PST,per=3,num=PL,aspect=PFV	süpürdüler
süpürüyorduk	pos=V,polar=NEG,mood=IND,inter=DECL,tense=PRS,per=3,num=PL,aspect=PROG	süpürmüyorlar
süpürüyordun	pos=V,polar=POS,mood=IND,inter=DECL,tense=PST,per=3,num=PL,aspect=PFV	süpürdüler
süpürüyordunuz	pos=V,polar=POS,mood=IND,inter=DECL,tense=PRS,per=1,num=PL,aspect={IPFV/PFV}	süpürürüz
süpürüyorsun	pos=V,polar=NEG,mood=IND,inter=DECL,tense=PRS,per=1,num=SG,aspect=PROG	süpürmüyorum
sürdük	pos=V,polar=NEG,mood=IND,inter=DECL,tense=PRS,per=1,num=PL,aspect=PROG	sürmüyoruz
sürdünüz	pos=V,polar=NEG,mood=IND,inter=DECL,tense=PRS,per=2,num=PL,aspect=PROG	sürmüyorsunuz
sürmedi	pos=V,polar=POS,mood=IND,inter=DECL,tense=PRS,per=1,num=SG,aspect={IPFV/PFV}	sürerim
sürüleceksin	pos=V,polar=POS,mood=IND,inter=DECL,tense=PRS,per=2,num=SG,aspect=PROG	sürülüyorsun
sürülmediniz	pos=V,polar=NEG,mood=IND,inter=DECL,tense=PRS,per=2,num=PL,aspect={IPFV/PFV}	sürülmezsiniz
sürülmem	pos=V,polar=POS,mood=IND,inter=DECL,tense=PRS,per=3,num=SG,aspect={IPFV/PFV}	sürülür
sürülüyordunuz	pos=V,polar=NEG,mood=IND,inter=DECL,tense=PST,per=3,num=SG,aspect={IPFV/PROG}	sürülmüyordu
sürülüyorsun	pos=V,polar=NEG,mood=IND,inter=DECL,tense=PRS,per=1,num=SG,aspect={IPFV/PFV}	sürülmem
süründüm	pos=V,polar=POS,mood=IND,inter=DECL,tense=PST,per=2,num=SG,aspect=PFV	süründün
süründürtmeyeceksiniz	pos=V,polar=NEG,mood=IND,inter=DECL,tense=PST,per=3,num=SG,aspect={IPFV/PROG}	süründürtmüyordu
süründürtmeyiz	pos=V,polar=POS,mood=IND,inter=DECL,tense=PST,per=2,num=PL,aspect={IPFV/PROG}	süründürtüyordunuz
süründürtmüyordu	pos=V,polar=NEG,mood=IND,inter=DECL,tense=PST,per=2,num=SG,aspect=PFV	süründürtmedin
süründürtmüyorlar	pos=V,polar=NEG,mood=IND,inter=DECL,tense=PRS,per=2,num=SG,aspect={IPFV/PFV}	süründürtmezsin
süründürtürsün	pos=V,polar=POS,mood=IND,inter=DECL,tense=PST,per=3,num=SG,aspect={IPFV/PROG}	süründürtüyordu
süründürtürüm	pos=V,polar=POS,mood=IND,inter=DECL,tense=PST,per=1,num=SG,aspect=PFV	süründürttüm
süründürür	pos=V,polar=NEG,mood=IND,inter=DECL,tense=PST,per=2,num=SG,aspect={IPFV/PROG}	süründürmüyordun
sürünmedik	pos=V,polar=NEG,mood=IND,inter=DECL,tense=PST,per=2,num=SG,aspect=PFV	sürünmedin
sürünmedi	pos=V,polar=POS,mood=IND,inter=DECL,tense=PRS,per=1,num=SG,aspect={IPFV/PFV}	sürünürüm
sürünmeyeceksin	pos=V,polar=NEG,mood=IND,inter=DECL,tense=PST,per=1,num=SG,aspect={IPFV/PROG}	sürünmüyordum
sürünmüyorduk	pos=V,polar=NEG,mood=IND,inter=DECL,tense=PRS,per=3,num=SG,aspect={IPFV/PFV}	sürünmez
sürünmüyordunuz	pos=V,polar=NEG,mood=IND,inter=DECL,tense=PRS,per=1,num=PL,aspect={IPFV/PFV}	sürünmeyiz
sürünüyorlardı	pos=V,polar=POS,mood=IND,inter=DECL,tense=PRS,per=3,num=SG,aspect={IPFV/PFV}	sürünür
sürüyordum	pos=V,polar=NEG,mood=IND,inter=DECL,tense=PRS,per=2,num=SG,aspect={IPFV/PFV}	sürmezsin
susacak	pos=V,polar=NEG,mood=IND,inter=DECL,tense=PST,per=2,num=SG,aspect=PFV	susmadın
süsde	pos=N,tense=PRS,per=3,num=PL,aspect={IPFV/PFV}	süslerdir
susmadın	pos=V,polar=NEG,mood=IND,inter=DECL,tense=PRS,per=1,num=SG,aspect={IPFV/PFV}	susmam
susmuyorduk	pos=V,polar=NEG,mood=IND,inter=DECL,tense=PRS,per=2,num=PL,aspect={IPFV/PFV}	susmazsınız
susmuyorduk	pos=V,polar=POS,mood=IND,inter=DECL,tense=PST,per=3,num=PL,aspect=PFV	sustular
susmuyorum	pos=V,polar=POS,mood=IND,inter=DECL,tense=PST,per=2,num=SG,aspect={IPFV/PROG}	susuyordun
susuyorlardı	pos=V,polar=NEG,mood=IND,inter=DECL,tense=PST,per=2,num=SG,aspect={IPFV/PROG}	susmuyordun
süzersin	pos=V,polar=NEG,mood=IND,inter=DECL,tense=PST,per=1,num=SG,aspect=PFV	süzmedim
süzmeyeceğim	pos=V,polar=POS,mood=IND,inter=DECL,tense=PST,per=2,num=PL,aspect=PFV	süzdünüz
süzmezler	pos=V,polar=NEG,mood=IND,inter=DECL,tense=PRS,per=3,num=SG,aspect={IPFV/PFV}	süzmez
süzmüyordular	pos=V,polar=NEG,mood=IND,inter=DECL,tense=PST,per=2,num=PL,aspect={IPFV/PROG}	süzmüyordunuz
süzüyorsun	pos=V,polar=NEG,mood=IND,inter=DECL,tense=PRS,per=3,num=SG,aspect=PROG	süzmüyor
tanıdım	pos=V,polar=POS,mood=IND,inter=DECL,tense=PRS,per=2,num=PL,aspect={IPFV/PFV}	tanırsınız
tanımaz	pos=V,polar=NEG,mood=IND,inter=DECL,tense=PRS,per=3,num=PL,aspect=PROG	tanımıyorlar
tanırız	pos=V,polar=NEG,mood=IND,inter=DECL,tense=PST,per=2,num=PL,aspect={IPFV/PROG}	tanımıyordunuz
tanırsın	pos=V,polar=POS,mood=IND,inter=DECL,tense=PRS,per=1,num=SG,aspect={IPFV/PFV}	tanırım
tanışmadı	pos=V,polar=NEG,mood=IND,inter=DECL,tense=PST,per=2,num=PL,aspect=PFV	tanışmadınız
tanışmazsınız	pos=V,polar=NEG,mood=IND,inter=DECL,tense=PST,per=3,num=SG,aspect=PFV	tanışmadı
tanışmıyordular	pos=V,polar=NEG,mood=IND,inter=DECL,tense=PST,per=1,num=PL,aspect=PFV	tanışmadık
tanışmıyordu	pos=V,polar=NEG,mood=IND,inter=DECL,tense=PRS,per=2,num=SG,aspect=PROG	tanışmıyorsun
tanıtıyordu	pos=V,polar=NEG,mood=IND,inter=DECL,tense=PST,per=3,num=SG,aspect={IPFV/PROG}	tanıtmıyordu
tanıtıyorlardı	pos=V,polar=POS,mood=IND,inter=DECL,tense=PRS,per=3,num=PL,aspect=PROG	tanıtıyorlar
tanıtmadık	pos=V,polar=NEG,mood=IND,inter=DECL,tense=PRS,per=1,num=SG,aspect={IPFV/PFV}	tanıtmam
tanıtmıyordunuz	pos=V,polar=POS,mood=IND,inter=DECL,tense=PRS,per=2,num=SG,aspect={IPFV/PFV}	tanıtırsın
tanıttım	pos=V,polar=POS,mood=IND,inter=DECL,tense=PRS,per=3,num=PL,aspect=PROG	tanıtıyorlar
tanıyordun	pos=V,polar=NEG,mood=IND,inter=DECL,tense=PRS,per=1,num=PL,aspect={IPFV/PFV}	tanımayız
tapacaksın	pos=V,polar=POS,mood=IND,inter=DECL,tense=PST,per=2,num=PL,aspect={IPFV/PROG}	tapıyordunuz
tapıyorduk	pos=V,polar=NEG,mood=IND,inter=DECL,tense=PST,per=1,num=SG,aspect=PFV	tapmadım
tapıyorsunuz	pos=V,polar=NEG,mood=IND,inter=DECL,tense=PST,per=1,num=PL,aspect=PFV	tapmadık
tarihçilerimizin	pos=N,tense=PRS,per=1,num=PL,aspect={IPFV/PFV}	tarihçileriz
taykonotunuzdan	pos=N,tense=PRS,per=2,num=PL,aspect={IPFV/PFV}	taykonotlarsınız
temizlemedik	pos=V,polar=POS,mood=IND,inter=DECL,tense=PST,per=3,num=SG,aspect=PFV	temizledi
temizlemeyeceğim	pos=V,polar=POS,mood=IND,inter=DECL,tense=PST,per=3,num=PL,aspect=PFV	temizlediler
temizlemiyorduk	pos=V,polar=POS,mood=IND,inter=DECL,tense=PRS,per=3,num=PL,aspect=PROG	temizliyorlar
temizlemiyordum	pos=V,polar=POS,mood=IND,inter=DECL,tense=PST,per=2,num=SG,aspect={IPFV/PROG}	temizliyordun
temizliyorduk	pos=V,polar=POS,mood=IND,inter=DECL,tense=PRS,per=2,num=SG,aspect=PROG	temizliyorsun
tercümanından	pos=N,tense=PRS,per=2,num=SG,aspect={IPFV/PFV}	tercümansınız
terörlerdiniz	pos=N,tense=PRS,per=3,num=PL,aspect={IPFV/PFV}	terörlerdir
tıklamadınız	pos=V,polar=POS,mood=IND,inter=DECL,tense=PRS,per=2,num=SG,aspect={IPFV/PFV}	tıklarsın
tıklamayacak	pos=V,polar=NEG,mood=IND,inter=DECL,tense=PST,per=2,num=PL,aspect={IPFV/PROG}	tıklamıyordunuz
tıklarsın	pos=V,polar=NEG,mood=IND,inter=DECL,tense=PRS,per=1,num=PL,aspect={IPFV/PFV}	tıklamayız
tıklıyorlar	pos=V,polar=NEG,mood=IND,inter=DECL,tense=PST,per=2,num=PL,aspect={IPFV/PROG}	tıklamıyordunuz
tıklıyorum	pos=V,polar=NEG,mood=IND,inter=DECL,tense=PRS,per=3,num=SG,aspect=PROG	tıklamıyor
titriyorum	pos=V,tense=PST,per=2,num=SG,aspect={IPFV/PROG}	titriyordun
tiyatroyduk	pos=N,tense=PRS,per=2,num=PL,aspect={IPFV/PFV}	tiyatrolarsınız
topçuda	pos=N,tense=PRS,per=2,num=SG,aspect={IPFV/PFV}	topçusunuz
tozlardır	pos=N,tense=PRS,per=1,num=SG,aspect={IPFV/PFV}	tozuz
tozlarmışsınız	pos=N,tense=PRS,per=1,num=SG,aspect={IPFV/PFV}	tozuz
tükürdük	pos=V,polar=NEG,mood=IND,inter=DECL,tense=PRS,per=1,num=SG,aspect=PROG	tükürmüyorum
tükürdün	pos=V,polar=NEG,mood=IND,inter=DECL,tense=PST,per=3,num=PL,aspect=PFV	tükürmediler
tükürmezsiniz	pos=V,polar=POS,mood=IND,inter=DECL,tense=PST,per=1,num=SG,aspect={IPFV/PROG}	tükürüyordum
tükürmüyorlar	pos=V,polar=POS,mood=IND,inter=DECL,tense=PRS,per=1,num=PL,aspect={IPFV/PFV}	tükürürüz
turşuymuşuz	pos=N,tense=PRS,per=1,num=SG,aspect={IPFV/PFV}	turşuyuz
tutkularınızda	pos=N,tense=PRS,per=2,num=PL,aspect={IPFV/PFV}	tutkularsınız
tutkularmışız	pos=N,tense=PRS,per=1,num=PL,aspect={IPFV/PFV}	tutkularız
tutkumuzdan	pos=N,tense=PRS,per=1,num=SG,aspect={IPFV/PFV}	tutkuyuz
tutmadılar	pos=V,polar=NEG,mood=IND,inter=DECL,tense=PRS,per=1,num=SG,aspect={IPFV/PFV}	tutmam
tütmediler	pos=V,polar=POS,mood=IND,inter=DECL,tense=PST,per=3,num=PL,aspect={IPFV/PROG}	tütüyorlardı
tütmeyiz	pos=V,polar=POS,mood=IND,inter=DECL,tense=PRS,per=1,num=SG,aspect=PROG	tütüyorum
tutmuyor	pos=V,polar=NEG,mood=IND,inter=DECL,tense=PRS,per=3,num=SG,aspect={IPFV/PFV}	tutmaz
tütmüyorum	pos=V,polar=NEG,mood=IND,inter=DECL,tense=PRS,per=2,num=SG,aspect={IPFV/PFV}	tütmezsin
tütsülerin	pos=N,tense=PRS,per=3,num=SG,aspect={IPFV/PFV}	tütsüler
tütsüleri	pos=N,tense=PRS,per=1,num=SG,aspect={IPFV/PFV}	tütsüyüz
tüttün	pos=V,polar=POS,mood=IND,inter=DECL,tense=PRS,per=3,num=SG,aspect={IPFV/PFV}	tüter
tutuşturmayacağız	pos=V,polar=NEG,mood=IND,inter=DECL,tense=PRS,per=2,num=PL,aspect={IPFV/PFV}	tutuşturmazsınız
tutuşturmayacağız	pos=V,polar=NEG,mood=IND,inter=DECL,tense=PRS,per=3,num=PL,aspect=PROG	tutuşturmuyorlar
tutuşturursun	pos=V,polar=NEG,mood=IND,inter=DECL,tense=PST,per=2,num=SG,aspect=PFV	tutuşturmadın
tutuşturuyorlar	pos=V,polar=NEG,mood=IND,inter=DECL,tense=PRS,per=2,num=PL,aspect={IPFV/PFV}	tutuşturmazsınız
tütüyordun	pos=V,polar=POS,mood=IND,inter=DECL,tense=PST,per=3,num=PL,aspect=PFV	tüttüler
tütüyorlardı	pos=V,polar=POS,mood=IND,inter=DECL,tense=PRS,per=2,num=SG,aspect={IPFV/PFV}	tütersin
uçacağız	pos=V,polar=POS,mood=IND,inter=DECL,tense=PST,per=1,num=SG,aspect=PFV	uçtum
uçarsın	pos=V,polar=POS,mood=IND,inter=DECL,tense=PST,per=3,num=SG,aspect={IPFV/PROG}	uçuyordu
uçmayacağız	pos=V,polar=NEG,mood=IND,inter=DECL,tense=PRS,per=1,num=PL,aspect={IPFV/PFV}	uçmayız
uçmaz	pos=V,polar=POS,mood=IND,inter=DECL,tense=PRS,per=3,num=SG,aspect=PROG	uçuyor
uçmuyorduk	pos=V,polar=NEG,mood=IND,inter=DECL,tense=PRS,per=2,num=SG,aspect=PROG	uçmuyorsun
uçmuyordum	pos=V,polar=NEG,mood=IND,inter=DECL,tense=PRS,per=2,num=SG,aspect=PROG	uçmuyorsun
uçmuyorlar	pos=V,polar=NEG,mood=IND,inter=DECL,tense=PST,per=3,num=PL,aspect=PFV	uçmadılar
uçmuyorsunuz	pos=V,polar=POS,mood=IND,inter=DECL,tense=PRS,per=1,num=SG,aspect=PROG	uçuyorum
uçtu	pos=V,polar=NEG,mood=IND,inter=DECL,tense=PST,per=1,num=SG,aspect={IPFV/PROG}	uçmuyordum
ucubenizi	pos=N,tense=PRS,per=3,num=PL,aspect={IPFV/PFV}	ucubelerdir
ucubesi	pos=N,tense=PRS,per=3,num=PL,aspect={IPFV/PFV}	ucubelerdir
uğratıldılar	pos=V,polar=NEG,mood=IND,inter=DECL,tense=PRS,per=2,num=PL,aspect={IPFV/PFV}	uğratılmazsınız
uğratıldı	pos=V,polar=NEG,mood=IND,inter=DECL,tense=PRS,per=3,num=SG,aspect=PROG	uğratılmıyor
uğratılmayacaklar	pos=V,polar=POS,mood=IND,inter=DECL,tense=PRS,per=1,num=PL,aspect=PROG	uğratılıyoruz
uğratılmıyordun	pos=V,polar=POS,mood=IND,inter=DECL,tense=PRS,per=1,num=PL,aspect={IPFV/PFV}	uğratılırız
uğratılmıyorsun	pos=V,polar=POS,mood=IND,inter=DECL,tense=PRS,per=1,num=PL,aspect=PROG	uğratılıyoruz
uğratırsınız	pos=V,polar=POS,mood=IND,inter=DECL,tense=PRS,per=1,num=PL,aspect={IPFV/PFV}	uğratırız
ummanında	pos=N,tense=PRS,per=2,num=PL,aspect={IPFV/PFV}	ummanlarsınız
unuturlar	pos=V,polar=POS,mood=IND,inter=DECL,tense=PST,per=2,num=SG,aspect=PFV	unuttun
üreteceksin	pos=V,polar=NEG,mood=IND,inter=DECL,tense=PRS,per=1,num=PL,aspect={IPFV/PFV}	üretmeyiz
üreticilerinizin	pos=N,tense=PRS,per=3,num=PL,aspect={IPFV/PFV}	üreticilerdir
üreticiymişiz	pos=N,tense=PRS,per=1,num=SG,aspect={IPFV/PFV}	üreticiyiz
üretmeyeceksin	pos=V,polar=POS,mood=IND,inter=DECL,tense=PRS,per=2,num=PL,aspect={IPFV/PFV}	üretirsiniz
üretmiyoruz	pos=V,polar=POS,mood=IND,inter=DECL,tense=PRS,per=1,num=SG,aspect={IPFV/PFV}	üretirim
ürettin	pos=V,polar=NEG,mood=IND,inter=DECL,tense=PRS,per=3,num=PL,aspect=PROG	üretmiyorlar
üşenirler	pos=V,polar=POS,mood=IND,inter=DECL,tense=PST,per=3,num=SG,aspect={IPFV/PROG}	üşeniyordu
üşeniyoruz	pos=V,polar=NEG,mood=IND,inter=DECL,tense=PST,per=2,num=PL,aspect={IPFV/PROG}	üşenmiyordunuz
üşenmiyorlar	pos=V,polar=NEG,mood=IND,inter=DECL,tense=PST,per=3,num=PL,aspect={IPFV/PROG}	üşenmiyordular
üşenmiyorum	pos=V,polar=NEG,mood=IND,inter=DECL,tense=PRS,per=2,num=PL,aspect=PROG	üşenmiyorsunuz
ustamın	pos=N,tense=PRS,per=3,num=PL,aspect={IPFV/PFV}	ustalardır
üşüyeceğiz	pos=V,tense=PRS,per=2,num=PL,aspect=PROG	üşüyorsunuz
utandırıyordunuz	pos=V,polar=NEG,mood=IND,inter=DECL,tense=PST,per=3,num=SG,aspect={IPFV/PROG}	utandırmıyordu
utandırmadık	pos=V,polar=NEG,mood=IND,inter=DECL,tense=PRS,per=1,num=SG,aspect={IPFV/PFV}	utandırmam
utandırmayacağız	pos=V,polar=POS,mood=IND,inter=DECL,tense=PST,per=3,num=SG,aspect=PFV	utandırdı
utanırım	pos=V,polar=POS,mood=IND,inter=DECL,tense=PST,per=1,num=SG,aspect={IPFV/PROG}	utanıyordum
utanıyorsunuz	pos=V,polar=NEG,mood=IND,inter=DECL,tense=PRS,per=2,num=SG,aspect={IPFV/PFV}	utanmazsın
utanıyorum	pos=V,polar=POS,mood=IND,inter=DECL,tense=PRS,per=3,num=SG,aspect=PROG	utanıyor
utanmıyorum	pos=V,polar=NEG,mood=IND,inter=DECL,tense=PST,per=1,num=PL,aspect=PFV	utanmadık
utanmıyoruz	pos=V,polar=POS,mood=IND,inter=DECL,tense=PRS,per=3,num=SG,aspect=PROG	utanıyor
ütülerimizde	pos=N,tense=PRS,per=3,num=SG,aspect={IPFV/PFV}	ütüler
ütülerinizden	pos=N,tense=PRS,per=2,num=SG,aspect={IPFV/PFV}	ütüsünüz
uyandınız	pos=V,polar=NEG,mood=IND,inter=DECL,tense=PRS,per=2,num=SG,aspect=PROG	uyanmıyorsun
uyandı	pos=V,polar=NEG,mood=IND,inter=DECL,tense=PRS,per=1,num=PL,aspect=PROG	uyanmıyoruz
uyanır	pos=V,polar=NEG,mood=IND,inter=DECL,tense=PST,per=3,num=PL,aspect={IPFV/PROG}	uyanmıyordular
uyanmayacak	pos=V,polar=POS,mood=IND,inter=DECL,tense=PST,per=1,num=SG,aspect=PFV	uyandım
uyanmayız	pos=V,polar=NEG,mood=IND,inter=DECL,tense=PST,per=1,num=PL,aspect={IPFV/PROG}	uyanmıyorduk
uyanmıyordun	pos=V,polar=POS,mood=IND,inter=DECL,tense=PRS,per=1,num=PL,aspect={IPFV/PFV}	uyanırız
uyarıyor	pos=V,polar=POS,mood=IND,inter=DECL,tense=PST,per=2,num=SG,aspect={IPFV/PROG}	uyarıyordun
uyarmadım	pos=V,polar=POS,mood=IND,inter=DECL,tense=PST,per=2,num=PL,aspect={IPFV/PROG}	uyarıyordunuz
uyarmadı	pos=V,polar=NEG,mood=IND,inter=DECL,tense=PST,per=3,num=PL,aspect={IPFV/PROG}	uyarmıyordular
uyarmazlar	pos=V,polar=POS,mood=IND,inter=DECL,tense=PRS,per=2,num=SG,aspect={IPFV/PFV}	uyarırsın
uyarmıyoruz	pos=V,polar=POS,mood=IND,inter=DECL,tense=PRS,per=1,num=SG,aspect={IPFV/PFV}	uyarırım
uydularımızda	pos=N,tense=PRS,per=3,num=SG,aspect={IPFV/PFV}	uydular
uymazlar	pos=V,polar=POS,mood=IND,inter=DECL,tense=PST,per=3,num=SG,aspect=PFV	uydu
uyudun	pos=V,polar=POS,mood=IND,inter=DECL,tense=PRS,per=2,num=PL,aspect=PROG	uyuyorsunuz
uyuyor	pos=V,polar=POS,mood=IND,inter=DECL,tense=PRS,per=1,num=PL,aspect=PROG	uyuyoruz
üzülecekler	pos=V,tense=PST,per=1,num=SG,aspect={IPFV/PROG}	üzülüyordum
üzülürüz	pos=V,tense=PRS,per=3,num=PL,aspect={IPFV/PFV}	üzülürler
üzülüyorlar	pos=V,tense=PRS,per=3,num=PL,aspect={IPFV/PFV}	üzülürler
yağladım	pos=V,polar=POS,mood=IND,inter=DECL,tense=PRS,per=1,num=PL,aspect={IPFV/PFV}	yağlarız
yağlamazsın	pos=V,polar=POS,mood=IND,inter=DECL,tense=PRS,per=2,num=SG,aspect=PROG	yağlıyorsun
yağlamıyordular	pos=V,polar=NEG,mood=IND,inter=DECL,tense=PST,per=1,num=PL,aspect=PFV	yağlamadık
yağlamıyor	pos=V,polar=NEG,mood=IND,inter=DECL,tense=PST,per=2,num=SG,aspect=PFV	yağlamadın
yağlarız	pos=V,polar=POS,mood=IND,inter=DECL,tense=PST,per=3,num=SG,aspect={IPFV/PROG}	yağlıyordu
yağlıyordu	pos=V,polar=POS,mood=IND,inter=DECL,tense=PST,per=3,num=PL,aspect={IPFV/PROG}	yağlıyorlardı
yakacağız	pos=V,polar=POS,mood=IND,inter=DECL,tense=PST,per=3,num=SG,aspect=PFV	yaktı
yaklaşıyordunuz	pos=V,polar=NEG,mood=IND,inter=DECL,tense=PST,per=2,num=PL,aspect={IPFV/PROG}	yaklaşmıyordunuz
yaklaşmam	pos=V,polar=NEG,mood=IND,inter=DECL,tense=PRS,per=1,num=SG,aspect=PROG	yaklaşmıyorum
yaklaşmıyordum	pos=V,polar=NEG,mood=IND,inter=DECL,tense=PRS,per=2,num=SG,aspect=PROG	yaklaşmıyorsun
yakmazsın	pos=V,polar=NEG,mood=IND,inter=DECL,tense=PST,per=1,num=SG,aspect=PFV	yakmadım
yakmıyordunuz	pos=V,polar=POS,mood=IND,inter=DECL,tense=PST,per=1,num=SG,aspect=PFV	yaktım
yalanda	pos=N,tense=PRS,per=3,num=SG,aspect={IPFV/PFV}	yalanlar
yalımadık	pos=V,polar=POS,mood=IND,inter=DECL,tense=PRS,per=2,num=PL,aspect={IPFV/PFV}	yalarsınız
yalımam	pos=V,polar=POS,mood=IND,inter=DECL,tense=PRS,per=3,num=SG,aspect=PROG	yalıyor
yalımayacaksınız	pos=V,polar=POS,mood=IND,inter=DECL,tense=PST,per=2,num=SG,aspect={IPFV/PROG}	yalıyordun
yalıyacaksınız	pos=V,polar=POS,mood=IND,inter=DECL,tense=PST,per=2,num=PL,aspect={IPFV/PROG}	yalıyordunuz
yalıyor	pos=V,polar=NEG,mood=IND,inter=DECL,tense=PST,per=3,num=PL,aspect={IPFV/PROG}	yalımıyordular
yalıyoruz	pos=V,polar=NEG,mood=IND,inter=DECL,tense=PRS,per=3,num=PL,aspect={IPFV/PFV}	yalımazlar
yandım	pos=V,polar=POS,mood=IND,inter=DECL,tense=PST,per=1,num=SG,aspect={IPFV/PROG}	yanıyordum
yanmadım	pos=V,polar=POS,mood=IND,inter=DECL,tense=PRS,per=2,num=SG,aspect=PROG	yanıyorsun
yanmıyordunuz	pos=V,polar=POS,mood=IND,inter=DECL,tense=PRS,per=1,num=PL,aspect={IPFV/PFV}	yanarız
yanmıyorsunuz	pos=V,polar=NEG,mood=IND,inter=DECL,tense=PST,per=1,num=SG,aspect={IPFV/PROG}	yanmıyordum
yaparız	pos=V,polar=POS,mood=IND,inter=DECL,tense=PRS,per=3,num=PL,aspect={IPFV/PFV}	yaparlar
yaparlar	pos=V,polar=NEG,mood=IND,inter=DECL,tense=PRS,per=3,num=SG,aspect={IPFV/PFV}	yapmaz
yaparsınız	pos=V,polar=POS,mood=IND,inter=DECL,tense=PRS,per=2,num=SG,aspect=PROG	yapıyorsun
yapılırım	pos=V,polar=POS,mood=IND,inter=DECL,tense=PST,per=2,num=PL,aspect=PFV	yapıldınız
yapılıyorlardı	pos=V,polar=NEG,mood=IND,inter=DECL,tense=PRS,per=3,num=SG,aspect=PROG	yapılmıyor
yapılmam	pos=V,polar=POS,mood=IND,inter=DECL,tense=PST,per=1,num=PL,aspect=PFV	yapıldık
yapılmayacağız	pos=V,polar=NEG,mood=IND,inter=DECL,tense=PST,per=1,num=SG,aspect=PFV	yapılmadım
yapılmaz	pos=V,polar=NEG,mood=IND,inter=DECL,tense=PRS,per=3,num=PL,aspect=PROG	yapılmıyorlar
yapıyorlar	pos=V,polar=NEG,mood=IND,inter=DECL,tense=PRS,per=2,num=PL,aspect={IPFV/PFV}	yapmazsınız
yapıyor	pos=V,polar=NEG,mood=IND,inter=DECL,tense=PST,per=1,num=SG,aspect={IPFV/PROG}	yapmıyordum
yapmazlar	pos=V,polar=POS,mood=IND,inter=DECL,tense=PST,per=3,num=PL,aspect=PFV	yaptılar
yaptırırım	pos=V,polar=NEG,mood=IND,inter=DECL,tense=PRS,per=2,num=PL,aspect={IPFV/PFV}	yaptırmazsınız
yaptırırsınız	pos=V,polar=POS,mood=IND,inter=DECL,tense=PST,per=1,num=SG,aspect={IPFV/PROG}	yaptırıyordum
yaptırmam	pos=V,polar=POS,mood=IND,inter=DECL,tense=PST,per=2,num=SG,aspect=PFV	yaptırtın
yaptırmayacaklar	pos=V,polar=POS,mood=IND,inter=DECL,tense=PST,per=2,num=PL,aspect={IPFV/PROG}	yaptırıyordunuz
yaptırmazsın	pos=V,polar=NEG,mood=IND,inter=DECL,tense=PST,per=1,num=PL,aspect=PFV	yaptırmadık
yaptırtmazlar	pos=V,polar=POS,mood=IND,inter=DECL,tense=PST,per=2,num=PL,aspect={IPFV/PROG}	yaptırtıyordunuz
yaptırtmazsınız	pos=V,polar=NEG,mood=IND,inter=DECL,tense=PRS,per=2,num=SG,aspect={IPFV/PFV}	yaptırtmazsın
yaptırtmıyorsun	pos=V,polar=POS,mood=IND,inter=DECL,tense=PST,per=1,num=SG,aspect={IPFV/PROG}	yaptırtıyordum
yaptırtmıyorsunuz	pos=V,polar=POS,mood=IND,inter=DECL,tense=PRS,per=2,num=PL,aspect=PROG	yaptırtıyorsunuz
yaptırttı	pos=V,polar=POS,mood=IND,inter=DECL,tense=PRS,per=1,num=PL,aspect={IPFV/PFV}	yaptırtırız
yaracak	pos=V,polar=NEG,mood=IND,inter=DECL,tense=PRS,per=2,num=PL,aspect=PROG	yarmıyorsunuz
yarasamı	pos=N,tense=PRS,per=2,num=SG,aspect={IPFV/PFV}	yarasasınız
yaratacaklar	pos=V,polar=POS,mood=IND,inter=DECL,tense=PST,per=2,num=PL,aspect=PFV	yarattınız
yaratılarınızdan	pos=N,tense=PRS,per=3,num=SG,aspect={IPFV/PFV}	yaratılar
yaratınızda	pos=N,tense=PRS,per=3,num=PL,aspect={IPFV/PFV}	yaratılardır
yaratmadın	pos=V,polar=POS,mood=IND,inter=DECL,tense=PST,per=3,num=SG,aspect={IPFV/PROG}	yaratıyordu
yarmayız	pos=V,polar=POS,mood=IND,inter=DECL,tense=PST,per=3,num=PL,aspect=PFV	yardılar
yayalarının	pos=N,tense=PRS,per=1,num=PL,aspect={IPFV/PFV}	yayalarız
yazıyordu	pos=V,polar=POS,mood=IND,inter=DECL,tense=PRS,per=3,num=PL,aspect=PROG	yazıyorlar
yazmayacaklar	pos=V,polar=POS,mood=IND,inter=DECL,tense=PST,per=3,num=PL,aspect={IPFV/PROG}	yazıyorlardı
yedirmediniz	pos=V,polar=NEG,mood=IND,inter=DECL,tense=PST,per=1,num=SG,aspect={IPFV/PROG}	yedirmiyordum
yedirmem	pos=V,polar=NEG,mood=IND,inter=DECL,tense=PRS,per=2,num=PL,aspect=PROG	yedirmiyorsunuz
yedirteceğiz	pos=V,polar=NEG,mood=IND,inter=DECL,tense=PRS,per=3,num=SG,aspect={IPFV/PFV}	yedirtmez
yedirteceksiniz	pos=V,polar=NEG,mood=IND,inter=DECL,tense=PST,per=1,num=PL,aspect=PFV	yedirtmedik
yedirtirim	pos=V,polar=POS,mood=IND,inter=DECL,tense=PRS,per=1,num=PL,aspect=PROG	yedirtiyoruz
yedirtiyordu	pos=V,polar=NEG,mood=IND,inter=DECL,tense=PRS,per=2,num=PL,aspect={IPFV/PFV}	yedirtmezsiniz
yedirtmeyeceğiz	pos=V,polar=NEG,mood=IND,inter=DECL,tense=PRS,per=1,num=PL,aspect=PROG	yedirtmiyoruz
yedirtmezler	pos=V,polar=POS,mood=IND,inter=DECL,tense=PRS,per=1,num=SG,aspect=PROG	yedirtiyorum
yelkenimizde	pos=N,tense=PRS,per=1,num=PL,aspect={IPFV/PFV}	yelkenleriz
yendirdim	pos=V,polar=POS,mood=IND,inter=DECL,tense=PRS,per=3,num=PL,aspect=PROG	yendiriyorlar
yendiririm	pos=V,polar=NEG,mood=IND,inter=DECL,tense=PRS,per=3,num=PL,aspect=PROG	yendirmiyorlar
yendiriyor	pos=V,polar=POS,mood=IND,inter=DECL,tense=PST,per=1,num=SG,aspect=PFV	yendirdim
yendirmedim	pos=V,polar=POS,mood=IND,inter=DECL,tense=PST,per=1,num=SG,aspect={IPFV/PROG}	yendiriyordum
yendirtirsin	pos=V,polar=NEG,mood=IND,inter=DECL,tense=PST,per=3,num=SG,aspect=PFV	yendirtmedi
yendirtiyorduk	pos=V,polar=POS,mood=IND,inter=DECL,tense=PRS,per=2,num=PL,aspect={IPFV/PFV}	yendirtirsiniz
yendirtmiyorduk	pos=V,polar=NEG,mood=IND,inter=DECL,tense=PST,per=2,num=PL,aspect={IPFV/PROG}	yendirtmiyordunuz
yendirtmiyorlar	pos=V,polar=NEG,mood=IND,inter=DECL,tense=PST,per=2,num=PL,aspect={IPFV/PROG}	yendirtmiyordunuz
yenildiler	pos=V,polar=NEG,mood=IND,inter=DECL,tense=PST,per=3,num=SG,aspect=PFV	yenilmedi
yenilirsiniz	pos=V,polar=NEG,mood=IND,inter=DECL,tense=PRS,per=2,num=PL,aspect=PROG	yenilmiyorsunuz
yenilmedin	pos=V,polar=POS,mood=IND,inter=DECL,tense=PRS,per=3,num=SG,aspect=PROG	yeniliyor
yenilmeyeceksin	pos=V,polar=POS,mood=IND,inter=DECL,tense=PST,per=2,num=PL,aspect={IPFV/PROG}	yeniliyordunuz
yenilmiyordum	pos=V,polar=NEG,mood=IND,inter=DECL,tense=PST,per=2,num=PL,aspect=PFV	yenilmediniz
yenilmiyordun	pos=V,polar=POS,mood=IND,inter=DECL,tense=PRS,per=1,num=PL,aspect=PROG	yeniliyoruz
yenilmiyorsunuz	pos=V,polar=POS,mood=IND,inter=DECL,tense=PRS,per=2,num=PL,aspect=PROG	yeniliyorsunuz
yerleşiyorum	pos=V,polar=POS,mood=IND,inter=DECL,tense=PRS,per=2,num=SG,aspect=PROG	yerleşiyorsun
yerleşmem	pos=V,polar=NEG,mood=IND,inter=DECL,tense=PST,per=1,num=PL,aspect={IPFV/PROG}	yerleşmiyorduk
yerleşmiyor	pos=V,polar=NEG,mood=IND,inter=DECL,tense=PRS,per=2,num=PL,aspect={IPFV/PFV}	yerleşmezsiniz
yerleşmiyorum	pos=V,polar=POS,mood=IND,inter=DECL,tense=PST,per=2,num=SG,aspect={IPFV/PROG}	yerleşiyordun
yeterliklermiş	pos=N,tense=PRS,per=1,num=SG,aspect={IPFV/PFV}	yeterliğiz
yeterliliğinizden	pos=N,tense=PRS,per=1,num=SG,aspect={IPFV/PFV}	yeterliliğiz
yetersizlikten	pos=N,tense=PRS,per=3,num=PL,aspect={IPFV/PFV}	yetersizliklerdir
yetişecekler	pos=V,polar=POS,mood=IND,inter=DECL,tense=PST,per=2,num=SG,aspect={IPFV/PROG}	yetişiyordun
yetişiyorduk	pos=V,polar=NEG,mood=IND,inter=DECL,tense=PRS,per=2,num=PL,aspect=PROG	yetişmiyorsunuz
yetişiyordum	pos=V,polar=NEG,mood=IND,inter=DECL,tense=PRS,per=3,num=PL,aspect={IPFV/PFV}	yetişmezler
yetişmiyorduk	pos=V,polar=POS,mood=IND,inter=DECL,tense=PST,per=3,num=PL,aspect={IPFV/PROG}	yetişiyorlardı
yetiştirdiler	pos=V,polar=POS,mood=IND,inter=DECL,tense=PST,per=2,num=SG,aspect=PFV	yetiştirdin
yetiştirdi	pos=V,polar=NEG,mood=IND,inter=DECL,tense=PST,per=2,num=SG,aspect={IPFV/PROG}	yetiştirmiyordun
yetiştirirsin	pos=V,polar=POS,mood=IND,inter=DECL,tense=PST,per=2,num=PL,aspect=PFV	yetiştirdiniz
yetiştiriyordum	pos=V,polar=POS,mood=IND,inter=DECL,tense=PRS,per=3,num=PL,aspect={IPFV/PFV}	yetiştirirler
yetiştirmedik	pos=V,polar=POS,mood=IND,inter=DECL,tense=PRS,per=3,num=PL,aspect=PROG	yetiştiriyorlar
yetiştirmiyorduk	pos=V,polar=POS,mood=IND,inter=DECL,tense=PRS,per=3,num=SG,aspect={IPFV/PFV}	yetiştirir
yetiştirmiyorsun	pos=V,polar=POS,mood=IND,inter=DECL,tense=PST,per=1,num=PL,aspect={IPFV/PROG}	yetiştiriyorduk
yetmezliğinizi	pos=N,tense=PRS,per=2,num=SG,aspect={IPFV/PFV}	yetmezliksiniz
yıkacaksın	pos=V,polar=NEG,mood=IND,inter=DECL,tense=PRS,per=3,num=PL,aspect={IPFV/PFV}	yıkmazlar
yıkarsın	pos=V,polar=NEG,mood=IND,inter=DECL,tense=PST,per=1,num=PL,aspect={IPFV/PROG}	yıkmıyorduk
yıkıyorduk	pos=V,polar=NEG,mood=IND,inter=DECL,tense=PRS,per=1,num=SG,aspect={IPFV/PFV}	yıkmam
yıkıyoruz	pos=V,polar=POS,mood=IND,inter=DECL,tense=PRS,per=1,num=SG,aspect={IPFV/PFV}	yıkarım
yıkmayacak	pos=V,polar=POS,mood=IND,inter=DECL,tense=PST,per=1,num=PL,aspect=PFV	yıktık
yıkmayız	pos=V,polar=POS,mood=IND,inter=DECL,tense=PST,per=1,num=PL,aspect=PFV	yıktık
yıkmıyor	pos=V,polar=POS,mood=IND,inter=DECL,tense=PRS,per=1,num=SG,aspect={IPFV/PFV}	yıkarım
yıkmıyorsun	pos=V,polar=POS,mood=IND,inter=DECL,tense=PST,per=3,num=PL,aspect=PFV	yıktılar
yıprandınız	pos=V,polar=NEG,mood=IND,inter=DECL,tense=PST,per=3,num=SG,aspect=PFV	yıpranmadı
yıpranırız	pos=V,polar=POS,mood=IND,inter=DECL,tense=PST,per=1,num=SG,aspect={IPFV/PROG}	yıpranıyordum
yıpranıyorum	pos=V,polar=POS,mood=IND,inter=DECL,tense=PST,per=3,num=PL,aspect={IPFV/PROG}	yıpranıyorlardı
yıpranmayacağım	pos=V,polar=NEG,mood=IND,inter=DECL,tense=PST,per=1,num=PL,aspect=PFV	yıpranmadık
yıpranmıyordunuz	pos=V,polar=NEG,mood=IND,inter=DECL,tense=PST,per=3,num=PL,aspect=PFV	yıpranmadılar
yıpratırlar	pos=V,polar=NEG,mood=IND,inter=DECL,tense=PRS,per=3,num=SG,aspect={IPFV/PFV}	yıpratmaz
yıpratıyorsun	pos=V,polar=NEG,mood=IND,inter=DECL,tense=PRS,per=3,num=PL,aspect={IPFV/PFV}	yıpratmazlar
yıpratmadık	pos=V,polar=POS,mood=IND,inter=DECL,tense=PST,per=1,num=SG,aspect={IPFV/PROG}	yıpratıyordum
yoğurmayacaksınız	pos=V,polar=POS,mood=IND,inter=DECL,tense=PRS,per=3,num=SG,aspect={IPFV/PFV}	yoğurur
yoğurmazsınız	pos=V,polar=NEG,mood=IND,inter=DECL,tense=PRS,per=2,num=SG,aspect={IPFV/PFV}	yoğurmazsın
yoğuruyordum	pos=V,polar=NEG,mood=IND,inter=DECL,tense=PRS,per=1,num=PL,aspect={IPFV/PFV}	yoğurmayız
yoksullaştıracağız	pos=V,polar=NEG,mood=IND,inter=DECL,tense=PRS,per=3,num=SG,aspect=PROG	yoksullaştırmıyor
yoksullaştırdık	pos=V,polar=NEG,mood=IND,inter=DECL,tense=PST,per=1,num=PL,aspect={IPFV/PROG}	yoksullaştırmıyorduk
yoksullaştırdın	pos=V,polar=NEG,mood=IND,inter=DECL,tense=PRS,per=3,num=SG,aspect=PROG	yoksullaştırmıyor
yoksullaştırırlar	pos=V,polar=NEG,mood=IND,inter=DECL,tense=PRS,per=2,num=PL,aspect=PROG	yoksullaştırmıyorsunuz
yoksullaştırırlar	pos=V,polar=POS,mood=IND,inter=DECL,tense=PRS,per=1,num=SG,aspect=PROG	yoksullaştırıyorum
yoksullaştırırlar	pos=V,polar=POS,mood=IND,inter=DECL,tense=PST,per=1,num=SG,aspect={IPFV/PROG}	yoksullaştırıyordum
yoksullaştırırsın	pos=V,polar=POS,mood=IND,inter=DECL,tense=PRS,per=3,num=SG,aspect=PROG	yoksullaştırıyor
yoksullaştırıyordum	pos=V,polar=NEG,mood=IND,inter=DECL,tense=PRS,per=1,num=PL,aspect={IPFV/PFV}	yoksullaştırmayız
yoksullaştırıyorlardı	pos=V,polar=NEG,mood=IND,inter=DECL,tense=PRS,per=1,num=PL,aspect=PROG	yoksullaştırmıyoruz
yoksullaştırmıyordular	pos=V,polar=POS,mood=IND,inter=DECL,tense=PRS,per=1,num=SG,aspect={IPFV/PFV}	yoksullaştırırım
yolarlar	pos=V,polar=NEG,mood=IND,inter=DECL,tense=PST,per=1,num=SG,aspect=PFV	yolmadım
yoldaşımızı	pos=N,tense=PRS,per=3,num=SG,aspect={IPFV/PFV}	yoldaşlar
yoldurduk	pos=V,polar=NEG,mood=IND,inter=DECL,tense=PST,per=2,num=SG,aspect=PFV	yoldurmadın
yoldurmadın	pos=V,polar=NEG,mood=IND,inter=DECL,tense=PST,per=1,num=SG,aspect=PFV	yoldurmadım
yoldurmadı	pos=V,polar=NEG,mood=IND,inter=DECL,tense=PRS,per=3,num=PL,aspect={IPFV/PFV}	yoldurmazlar
yoldurmayacağım	pos=V,polar=NEG,mood=IND,inter=DECL,tense=PRS,per=1,num=PL,aspect=PROG	yoldurmuyoruz
yoldurmaz	pos=V,polar=POS,mood=IND,inter=DECL,tense=PRS,per=1,num=SG,aspect={IPFV/PFV}	yoldururum
yoldurmuyor	pos=V,polar=NEG,mood=IND,inter=DECL,tense=PRS,per=3,num=PL,aspect={IPFV/PFV}	yoldurmazlar
yoldurtacaksın	pos=V,polar=NEG,mood=IND,inter=DECL,tense=PRS,per=3,num=SG,aspect={IPFV/PFV}	yoldurtmaz
yoldurtacaksın	pos=V,polar=NEG,mood=IND,inter=DECL,tense=PST,per=3,num=PL,aspect={IPFV/PROG}	yoldurtmuyordular
yoldurtmazlar	pos=V,polar=POS,mood=IND,inter=DECL,tense=PST,per=2,num=SG,aspect=PFV	yoldurttun
yoldurtmuyorlar	pos=V,polar=POS,mood=IND,inter=DECL,tense=PST,per=3,num=PL,aspect={IPFV/PROG}	yoldurtuyorlardı
yoldurtuyordu	pos=V,polar=NEG,mood=IND,inter=DECL,tense=PST,per=3,num=SG,aspect=PFV	yoldurtmadı
yoldurtuyordu	pos=V,polar=POS,mood=IND,inter=DECL,tense=PST,per=2,num=PL,aspect=PFV	yoldurttunuz
yolduruyorlar	pos=V,polar=POS,mood=IND,inter=DECL,tense=PRS,per=1,num=SG,aspect=PROG	yolduruyorum
yolduruyorsunuz	pos=V,polar=POS,mood=IND,inter=DECL,tense=PST,per=1,num=SG,aspect=PFV	yoldurdum
yolmadınız	pos=V,polar=NEG,mood=IND,inter=DECL,tense=PST,per=1,num=PL,aspect=PFV	yolmadık
yolunduracağım	pos=V,polar=POS,mood=IND,inter=DECL,tense=PRS,per=3,num=PL,aspect={IPFV/PFV}	yolundururlar
yolunduracağız	pos=V,polar=NEG,mood=IND,inter=DECL,tense=PST,per=3,num=PL,aspect={IPFV/PROG}	yolundurmuyordular
yolundurdu	pos=V,polar=POS,mood=IND,inter=DECL,tense=PRS,per=2,num=PL,aspect=PROG	yolunduruyorsunuz
yolundurtacaksın	pos=V,polar=POS,mood=IND,inter=DECL,tense=PRS,per=1,num=SG,aspect=PROG	yolundurtuyorum
yolundurtmadınız	pos=V,polar=NEG,mood=IND,inter=DECL,tense=PRS,per=3,num=SG,aspect={IPFV/PFV}	yolundurtmaz
yolundurtmadınız	pos=V,polar=POS,mood=IND,inter=DECL,tense=PRS,per=1,num=PL,aspect={IPFV/PFV}	yolundurturuz
yolundurtmayacaksınız	pos=V,polar=NEG,mood=IND,inter=DECL,tense=PST,per=2,num=PL,aspect={IPFV/PROG}	yolundurtmuyordunuz
yolundurtmuyordum	pos=V,polar=POS,mood=IND,inter=DECL,tense=PRS,per=3,num=PL,aspect=PROG	yolundurtuyorlar
yolundurtmuyordun	pos=V,polar=NEG,mood=IND,inter=DECL,tense=PRS,per=1,num=PL,aspect=PROG	yolundurtmuyoruz
yolundurttun	pos=V,polar=POS,mood=IND,inter=DECL,tense=PRS,per=2,num=SG,aspect={IPFV/PFV}	yolundurtursun
yolundurtuyorsunuz	pos=V,polar=NEG,mood=IND,inter=DECL,tense=PRS,per=1,num=PL,aspect=PROG	yolundurtmuyoruz
yolundurtuyorsunuz	pos=V,polar=POS,mood=IND,inter=DECL,tense=PRS,per=3,num=PL,aspect={IPFV/PFV}	yolundurturlar
yolunduruyordu	pos=V,polar=NEG,mood=IND,inter=DECL,tense=PRS,per=1,num=SG,aspect=PROG	yolundurmuyorum
yolunmazsın	pos=V,polar=NEG,mood=IND,inter=DECL,tense=PRS,per=1,num=PL,aspect=PROG	yolunmuyoruz
yolunuyorum	pos=V,polar=POS,mood=IND,inter=DECL,tense=PRS,per=1,num=PL,aspect=PROG	yolunuyoruz
yolunuyorum	pos=V,polar=POS,mood=IND,inter=DECL,tense=PST,per=2,num=PL,aspect=PFV	yolundunuz
yönlere	pos=N,tense=PRS,per=1,num=PL,aspect={IPFV/PFV}	yönleriz
yontuluyorduk	pos=V,polar=NEG,mood=IND,inter=DECL,tense=PRS,per=1,num=SG,aspect={IPFV/PFV}	yontulmam
yontuluyorduk	pos=V,polar=NEG,mood=IND,inter=DECL,tense=PRS,per=1,num=SG,aspect=PROG	yontulmuyorum
yontuluyoruz	pos=V,polar=POS,mood=IND,inter=DECL,tense=PST,per=1,num=PL,aspect=PFV	yontulduk
yorulmadılar	pos=V,polar=NEG,mood=IND,inter=DECL,tense=PST,per=3,num=SG,aspect={IPFV/PROG}	yorulmuyordu
yorulmadı	pos=V,polar=NEG,mood=IND,inter=DECL,tense=PST,per=3,num=PL,aspect=PFV	yorulmadılar
yorulmazlar	pos=V,polar=POS,mood=IND,inter=DECL,tense=PRS,per=3,num=PL,aspect={IPFV/PFV}	yorulurlar
yumuşaklarımızı	pos=N,tense=PRS,per=1,num=PL,aspect={IPFV/PFV}	yumuşaklarız
yürüdünüz	pos=V,polar=POS,mood=IND,inter=DECL,tense=PRS,per=2,num=PL,aspect={IPFV/PFV}	yürürsünüz
yürümeyecek	pos=V,polar=POS,mood=IND,inter=DECL,tense=PRS,per=3,num=PL,aspect=PROG	yürüyorlar
yürümezsin	pos=V,polar=NEG,mood=IND,inter=DECL,tense=PRS,per=2,num=SG,aspect=PROG	yürümüyorsun
yürümüyordunuz	pos=V,polar=POS,mood=IND,inter=DECL,tense=PST,per=2,num=SG,aspect=PFV	yürüdün
yürümüyoruz	pos=V,polar=NEG,mood=IND,inter=DECL,tense=PST,per=3,num=PL,aspect={IPFV/PROG}	yürümüyordular
yürüyeceğiz	pos=V,polar=POS,mood=IND,inter=DECL,tense=PRS,per=2,num=PL,aspect=PROG	yürüyorsunuz
yürüyorsunuz	pos=V,polar=NEG,mood=IND,inter=DECL,tense=PST,per=1,num=SG,aspect=PFV	yürümedim
yutacaklar	pos=V,polar=NEG,mood=IND,inter=DECL,tense=PST,per=3,num=SG,aspect=PFV	yutmadı
yutacaklar	pos=V,polar=POS,mood=IND,inter=DECL,tense=PST,per=3,num=SG,aspect={IPFV/PROG}	yutuyordu
yutarsın	pos=V,polar=NEG,mood=IND,inter=DECL,tense=PRS,per=1,num=SG,aspect=PROG	yutmuyorum
yuttular	pos=V,polar=POS,mood=IND,inter=DECL,tense=PRS,per=1,num=SG,aspect=PROG	yutuyorum
yüzdük	pos=V,polar=NEG,mood=IND,inter=DECL,tense=PST,per=2,num=SG,aspect=PFV	yüzmedin
yüzecekler	pos=V,polar=POS,mood=IND,inter=DECL,tense=PRS,per=2,num=SG,aspect=PROG	yüzüyorsun
yüzeceksiniz	pos=V,polar=POS,mood=IND,inter=DECL,tense=PST,per=3,num=SG,aspect=PFV	yüzdü
yüzmüyordunuz	pos=V,polar=POS,mood=IND,inter=DECL,tense=PRS,per=2,num=PL,aspect={IPFV/PFV}	yüzersiniz
yüzmüyordu	pos=V,polar=POS,mood=IND,inter=DECL,tense=PST,per=2,num=SG,aspect=PFV	yüzdün
yüzmüyor	pos=V,polar=NEG,mood=IND,inter=DECL,tense=PRS,per=2,num=PL,aspect={IPFV/PFV}	yüzmezsiniz
yüzüncüyünden	pos=N,tense=PRS,per=1,num=SG,aspect={IPFV/PFV}	yüzüncüyüz
yüzüyorsun	pos=V,polar=POS,mood=IND,inter=DECL,tense=PST,per=3,num=PL,aspect={IPFV/PROG}	yüzüyorlardı
ziyaretçinizi	pos=N,tense=PRS,per=2,num=PL,aspect={IPFV/PFV}	ziyaretçilersiniz
ziyaretçisinde	pos=N,tense=PRS,per=2,num=PL,aspect={IPFV/PFV}	ziyaretçilersiniz
ziyaretlerinizin	pos=N,tense=PRS,per=1,num=SG,aspect={IPFV/PFV}	ziyaretiz
